Johannes,Deigratia,Francorumrex	Johannes , Dei gratia , Francorum rex
.Notum..facimusuniversis,presentibusetfuturis,quod	. Notum . . facimus universis , presentibus et futuris , quod
quod,cumdefunctuscarissimusconsanguineusnoster	quod , cum defunctus carissimus consanguineus noster
,Karolus	, Karolus
deYspania;comes.	de Yspania ; comes .
..Engolismensis,	. . Engolismensis ,
connestabulariusFrancie,.attenteconsideransgrataetaccepta	connestabularius Francie , . attente considerans grata et accepta
serviciaqueArnaldusdeSanctoHermino,	servicia que Arnaldus de Sancto Hermino ,
scutifer,sibidiufecerat	scutifer , sibi diu fecerat
etfaciebat,	et faciebat ,
,universaetsingulabonaimmobilia	, universa et singula bona immobilia
seuhereditaria,.queOrricusdeSanctoPaulo	seu hereditaria , . que Orricus de Sancto Paulo
Paulo,filiusdefunctiHelyedeSanctoPaulo	Paulo , filius defuncti Helye de Sancto Paulo
,incastellaniadeBoutevillahabebat,	, in castellania de Boutevilla habebat ,
,etqueeidemconsanguineonostrodelatafuerant	, et que eidem consanguineo nostro delata fuerant
,propterrebellionemdictiOrrici,quinostrumseconstituerat	, propter rebellionem dicti Orrici , qui nostrum se constituerat
constitueratinimicum,subvaloreannuodecemlibrarum,adusum	constituerat inimicum , sub valore annuo decem librarum , ad usum
etconsuetudinemvicinepatrie,eidemArnaldodonaverit,pro	et consuetudinem vicine patrie , eidem Arnaldo donaverit , pro
seetsuisheredibusperpetuo,	se et suis heredibus perpetuo ,
proutinsuissuperhocconfectislitteriscontineri	prout in suis super hoc confectis litteris contineri
vidimus,sub	vidimus , sub
hiisverbis:	hiis verbis :
:Charlesd	: Charles d
d'Espaigne,conted	d ' Espaigne , conte d
d'Angolesme	d ' Angolesme
Angolesme,connestabledeFrance	Angolesme , connestable de France
,àtouzceulxquices	, à touz ceulx qui ces
lettresverront,salut	lettres verront , salut
.Savoirfaisonsque..,pourlesbonset	. Savoir faisons que . . , pour les bons et
aggreablesservicesquenostreaméescuier,Arnaut	aggreables services que nostre amé escuier , Arnaut
deSaint-Hermine,nous	de Saint - Hermine , nous
nousafaizet..esperonsqu'	nous a faiz et . . esperons qu '
ilnousfaceoutempsavenir,..etpourcontemplacion	il nous face ou temps avenir , . . et pour contemplacion
d'iceulx,àycellui	d ' iceulx , à ycellui
avonsdonnéetoctroyé,donnonset	avons donné et octroyé , donnons et
octroyonsdegraceespecialetdecertainescience,..	octroyons de grace especial et de certaine science , . .
parcespresentes,touzlesbiensmeubles	par ces presentes , touz les biens meubles
etheritagesquifurentdeOrritdeSaint-	et heritages qui furent de Orrit de Saint -
Pol,filsdefeumessireHéliesde	Pol , fils de feu messire Hélies de
deSaint-Pol,quis'	de Saint - Pol , qui s '
esttornez.à	est tornez . à
l'obeissance..	l ' obeissance . .
duroyd'Engleterre,nostre	du roy d ' Engleterre , nostre
ennemi..rebelle,estansetreseans	ennemi . . rebelle , estans et reseans
reseansenlachastelleniedeBouteville,ànousacquiset	reseans en la chastellenie de Bouteville , à nous acquis et
confisquezpourlarebelliondessusdicte.	confisquez pour la rebellion dessus dicte .
.Lesquiexbienspevent	. Les quiex biens pevent
peventvaloirdixlivres..	pevent valoir dix livres . .
.derente,	. de rente ,
àusetcoustumedupaïs,ou..	à us et coustume du païs , ou . .
environ,àlestenir,lever	environ , à les tenir , lever
,posseder..	, posseder . .
etexploitierperpetuelmentethereditablement,eten	et exploitier perpetuelment et hereditablement , et en
faire.sa	faire . sa
saplainierevolenté,commede	sa plainiere volenté , comme de
saproprechose.	sa propre chose .
.Sidonnons	. Si donnons
enmandement	en mandement
àtouznozjusticiers,officierset	à touz noz justiciers , officiers et
subgiez,presens.etavenir,qu'	subgiez , presens . et avenir , qu '
ilmettentrealmentet	il mettent realment et
defaitleditescuierenpossession	de fait le dit escuier en possession
possessionetsaisinedesdizbiens	possession et saisine des diz biens
biens,etl'enlaissentetfacentjouiret	biens , et l ' en laissent et facent jouir et
etuserpaisiblement,et,contrelateneurdeces	et user paisiblement , et , contre la teneur de ces
cespresentes,nele	ces presentes , ne le
molestentouempeschentenaucunemaniere,non	molestent ou empeschent en aucune maniere , non
obstantautredonpar	obstant autre don par
nousfaitauditescuier,nequelconquesordenances,	nous fait au dit escuier , ne quelconques ordenances ,
mandemensoudeffensesparnousfaiz..aucontraire	mandemens ou deffenses par nous faiz . . au contraire
contraire.Entesmoingde	contraire . En tesmoing de
ce,nousavonsfaitmettrenostreseelà	ce , nous avons fait mettre nostre seel à
ceslettres..DonnéesàCompnac,lexviiiejour	ces lettres . . Données à Compnac , le xviiie jour
demayl'an	de may l ' an
degracemilccc..cinquante	de grace mil ccc . . cinquante
etdeux.Noslitterassuprascriptas	et deux . Nos litteras suprascriptas
,donumetaliaineiscontenta,	, donum et alia in eis contenta ,
rataetgratahabentes.,ea,	rata et grata habentes . , ea ,
,tenorepresentium,despecialigraciaet	, tenore presentium , de speciali gracia et
auctoritateregia,confirmantes,	auctoritate regia , confirmantes ,
mandamussenescallocomitatus	mandamus senescallo comitatus
Engolismensisceterisquejusticiariisnostris,presentibusetfuturis,vel	Engolismensis ceterisque justiciariis nostris , presentibus et futuris , vel
eorumlocatenentibus..,et	eorum loca tenentibus . . , et
eorumcuilibet,utadeum	eorum cuilibet , ut ad eum
pertinuerit,quatinusdiclumArnaudum	pertinuerit , quatinus diclum Arnaudum
,suosqueheredes	, suosque heredes
etsuccessores,accausamabeishabituros,	et successores , ac causam ab eis habituros ,
bonisimmobilibusseuhereditariispredictis,subdictovalore	bonis immobilibus seu hereditariis predictis , sub dicto valore
,utifaciantetgaudereperpetuo,	, uti faciant et gaudere perpetuo ,
,pacificeetquiete,nonmolestantesipsos,vel	, pacifice et quiete , non molestantes ipsos , vel
veleorumaliquem,incontrarium	vel eorum aliquem , in contrarium
contrarium,autturbantes.Quodutfirmumet	contrarium , aut turbantes . Quod ut firmum et
etstabileperpetuoperseveret,sigillumnostriCastelletiParisiensis,in	et stabile perpetuo perseveret , sigillum nostri Castelleti Parisiensis , in
absenciamagni,hiislitterisest	absencia magni , hiislitteris est
appensum.Salvoin	appensum . Salvo in
aliisjurenostroetinomnibusquolibet	aliis jure nostro et in omnibus quolibet
alieno.DatumParisius,xxvadie	alieno . Datum Parisius , xxva die
diejanuariianno	die januarii anno
Dominim.cccquinquagesimoquarto.Perregem	Domini m . ccc quinquagesimo quarto . Per regem
regem,presentibusdominisepiscopoCathalaunensiet.comiteArmaniaci	regem , presentibus dominis episcopo Cathalaunensi et . comite Armaniaci
.YvoBucy.Collatiofacta	. Yvo Bucy . Collatio facta
