Johannes,Deigracia,Francorumrex.Notum	Johannes , Dei gracia , Francorum rex . Notum
Notumfacimusuniversis,tam	Notum facimus universis , tam
presentibusquamfuturis,quod	presentibus quam futuris , quod
,cumGuillelmusdeRocamonteetSymon	, cum Guillelmus de Rocamonte et Symon
SymondeRajace	Symon de Rajace
dudumverbisinjuriosisadinvicemcontenderent,	dudum verbis injuriosis ad invicem contenderent ,
,dictusSymonablatoensedictiGuillelmi,ipsumpluries	, dictus Symon ablato ense dicti Guillelmi , ipsum pluries
pluriespercussitinvultu	pluries percussit in vultu
etalibi,acaliasdiversimodovillipendendo	et alibi , ac alias diversimodo villipendendo
sibiinjuriamfecit,quividensnonposse	sibi injuriam fecit , qui videns non posse
tuncresisterenecsevindicaredepredictis,	tunc resistere nec se vindicare de predictis ,
,dixiteidem..Symoni	, dixit eidem . . Symoni
Symoniquodipsumgravaretetdampnificaretinfrabreve;et	Symoni quod ipsum gravaret et dampnificaret infra breve ; et
etincrastinumprefatusGuillelmus,causapredictaadiramnon	et in crastinum prefatus Guillelmus , causa predicta ad iram non
inmeritocommotus	inmerito commotus
,RollandoFretart,Hugueto	, Rollando Fretart , Hugueto
HuguetodeChaslus,MauricioMoreau,JohanneJarroceau.,Johanne	Hugueto de Chaslus , Mauricio Moreau , Johanne Jarroceau . , Johanne
JohanneCafforeauetJohanne	Johanne Cafforeau et Johanne
JohanneBurguereausibiassociatis	Johanne Burguereau sibi associatis
,ivitadaltamdomum..dictiSymoniseteamvi	, ivit ad altam domum . . dicti Symonis et eam vi
intravit,querendodictumSymonem;quononinvento	intravit , querendo dictum Symonem ; quo non invento
,dictus	, dictus
Guillelmus,	Guillelmus ,
accedensad.aliamdomumipsiusSymonis,duohostia	accedens ad . aliam domum ipsius Symonis , duo hostia
rupitettrescaudasvinieffudit.Occasionequorumprefati	rupit et tres caudas vini effudit . Occasione quorum prefati
prefatiGuillelmusetejuscomplices..	prefati Guillelmus et ejus complices . .
.,timentes	. , timentes
neproinde	ne proinde
ponerenturin	ponerentur in
carcere,..àpatriaseabsentarunt,etad	carcere , . . à patria se absentarunt , et ad
juranostravocatietnoncomparentes,bannitifuerunt	jura nostra vocati et non comparentes , banniti fuerunt
fuerunt.Supplicanteshumiliterut,	fuerunt . Supplicantes humiliter ut ,
attentisinjuriis	attentis injuriis
injuriiseidemGuillelmosinecausaillatis,quodqueipse	injuriis eidem Guillelmo sine causa illatis , quodque ipse
etprenominaticomplicesnobisinguerrisnostris,specialiterin	et prenominati complices nobis in guerris nostris , specialiter in
inrecuperandocastrumdeLodunoservierunt,	in recuperando castrum de Loduno servierunt ,
utdicitur,cum	ut dicitur , cum
eismisericorditeragere	eis misericorditer agere
dignaremur.Nos	dignaremur . Nos
igiturdicte	igitur dicte
supplicacioniinclinantes,	supplicacioni inclinantes ,
eisdemGuillelmoetcomplicibusdictumfactumet	eisdem Guillelmo et complicibus dictum factum et
etomnempenamcriminalem,quamincurreruntetincurrisse.potuerunt	et omnem penam criminalem , quam incurrerunt et incurrisse . potuerunt
indictocasu,de	in dicto casu , de
specialigraciaetauctoritatenostraregia,	speciali gracia et auctoritate nostra regia ,
remittimus..etquictamus,bannumetquicquidindesequtum	remittimus . . et quictamus , bannum et quicquid inde sequtum
estrevocando,ipsosqueadpatriametbonamfamamrestituimus	est revocando , ipsosque ad patriam et bonam famam restituimus
restituimus,satisfacto..tamenpartiet	restituimus , satisfacto . . tamen parti et
etsalvapunicionecivili.Senescallis	et salva punicione civili . Senescallis
CenomannensietAndegavensi,	Cenomannensi et Andegavensi ,
acPictavensi,ceterisquejusticiariisnostris,presentibus	ac Pictavensi , ceterisque justiciariis nostris , presentibus
presentibusetfuturis,eteorumlocatenentibus,	presentibus et futuris , et eorum locatenentibus ,
,dantes,tenorepresentium,inmandatisquatinus.sepedictosGuillelmum	, dantes , tenore presentium , in mandatis quatinus . sepedictos Guillelmum
etcomplicesnostrapresentigracia..	et complices nostra presenti gracia . .
utietgauderefaciantnecincontrariumipsos,	uti et gaudere faciant nec in contrarium ipsos ,
veleorumalterum,molestaripermittant	vel eorum alterum , molestari permittant
.Quodut..	. Quod ut . .
firmumetstabileperpetuoperseveretsigillumnostrumpresentibus.duximus	firmum et stabile perpetuo perseveret sigillum nostrum presentibus . duximus
apponendum.Salvoinaliisjurenostroet	apponendum . Salvo in aliis jure nostro et
inomnibusquolibet.	in omnibus quolibet .
alieno.Datuminabbacia	alieno . Datum in abbacia
abbaciaInsuleDei,annoDominimillesimo..ccc.	abbacia Insule Dei , anno Domini millesimo . . ccc .
quinquagesimosecundo	quinquagesimo secundo
,mensejanuarii.Inrequestis	, mense januarii . In requestis
hospicii.Marueil.	hospicii . Marueil .
