Karolus,Deigracia.	Karolus , Dei gracia .
Francorum.rex	Francorum . rex
rex.Illegitimegenitos,quosvitedecorat	rex . Illegitime genitos , quos vite decorat
honestasnatureviciumminime	honestas nature vicium minime
decolorat,namdecorvirtutisabsconditinprolemaculam..	decolorat , nam decor virtutis abscondit in prole maculam . .
.genitureetpudicicia..	. geniture et pudicicia . .
.morumpudororiginisaboletur.Notumigiturfacimus	. morum pudor originis aboletur . Notum igitur facimus
presentibusetfuturisquod,licet	presentibus et futuris quod , licet
AndreasdeSancto	Andreas de Sancto
Sebastiano,.	Sebastiano , .
filiusnaturalisquondamPetrideSancto	filius naturalis quondam Petri de Sancto
SanctoSebastiano,	Sancto Sebastiano ,
militis,etSibillede	militis , et Sibille de
Bosco,tunc.	Bosco , tunc .
uxorisPerriniDuVergier,exillicitacopulaoriginem	uxoris Perrini Du Vergier , ex illicita copula originem
traxerit,talibustamenvirtutis	traxerit , talibus tamen virtutis
virtutisdonoetmorum	virtutis dono et morum
venustatecoruscatquodinipsosupplent	venustate coruscat quod in ipso supplent
meritaetvirtutesquodortusodiosusadjecit,adeo	merita et virtutes quod ortus odiosus adjecit , adeo
quodsupereodefectunatalium,quempatitur,graciam	quod super eo defectu natalium , quem patitur , graciam
graciamquamnobishumillimeflagitavitanostra	graciam quam nobis humillime flagitavit a nostra
nostraregiamajestatemeruitobtinere.Nosigitur,hiisattentis	nostra regia majestate meruit obtinere . Nos igitur , hiis attentis
necnonconsideracioneserviciorumnobisalias	necnon consideracione serviciorum nobis alias
perpatremdictiAndreeinnostrisguerriscontraadversarios	per patrem dicti Andree in nostris guerris contra adversarios
nostrosantiquosetpresertim..	nostros antiquos et presertim . .
inbellodeVernueil,inquodiemsuum	in bello de Vernueil , in quo diem suum
clausitextremum,impensorum,	clausit extremum , impensorum ,
,eundemAndreamdeSanctoSebastianodenostreregiepotestatisplenitudine	, eundem Andream de Sancto Sebastiano de nostre regie potestatis plenitudine
plenitudine,certa..scienciaacspecialigracia	plenitudine , certa . . sciencia ac speciali gracia
gracialegitimavimusetlegitimamusperpresentes,aclegitimacionistitulodecoramus	gracia legitimavimus et legitimamus per presentes , ac legitimacionis titulo decoramus
,.ipsumquein	, . ipsumque in
injudicioetextraamodoprolegitimo.reputariet	in judicio et extra a modo pro legitimo . reputari et
censerivolumusethaberi.Concedenteseidemetcum	censeri volumus et haberi . Concedentes eidem et cum
eodispensantesut	eo dispensantes ut
ipse,..quamquamdedampnato	ipse , . . quamquam de dampnato
coitutraxeritoriginem,bonamobiliatemporalia	coitu traxerit originem , bona mobilia temporalia
etimmobiliaquecunqueacquirere	et immobilia quecunque acquirere
,etjamacquisitapossiderevaleatettenere	, et jam acquisita possidere valeat et tenere
tenere,etdeeisdemintervivos.	tenere , et de eisdem inter vivos .
velintestamentodisponereadsuelibitumvoluntatis	vel in testamento disponere ad sue libitum voluntatis
,adsuccessionemquedictorumpatrisetmatrisceterorumqueamicorumcarnalium	, ad successionemque dictorum patris et matris ceterorumque amicorum carnalium
carnaliumacaliorumquorumlibet,extestamentovelabintestato,	carnalium ac aliorum quorumlibet , ex testamento vel ab intestato ,
dummododeeorumprocesseritvoluntate,et	dummodo de eorum processerit voluntate , et
etnisialteriforetjusjamquesitum,etadquoscunque.	et nisi alteri foret jus jam quesitum , et ad quoscunque .
.honores,officiaaliosquelegitimosactus	. honores , officia aliosque legitimos actus
actusadmittatur,acsiessetde	actus admittatur , ac si esset de
delegitimomatrimonioprocreatus,quodqueeciamsuiliberi,si	de legitimo matrimonio procreatus , quodque eciam sui liberi , si
quosinfuturumhabeat,totaque	quos in futurum habeat , totaque
totaqueejusposteritasde	totaque ejus posteritas de
dematrimoniolegitimoprocreandainbonissuisquibuscunque	de matrimonio legitimo procreanda in bonis suis quibuscunque
eidemjurehereditariosuccedantetsuccederevaleant,.nisi	eidem jure hereditario succedant et succedere valeant , . nisi
aliudquamdefectushujusmodinataliumrepugnet,	aliud quam defectus hujusmodi natalium repugnet ,
predictodeffectu,quemprorsusabolemus,jure	predicto deffectu , quem prorsus abolemus , jure
jure,constitucione,..statuto	jure , constitucione , . . statuto
statuto,lege,edictoetconsuetudine,usugeneralivel	statuto , lege , edicto et consuetudine , usu generali vel
localiregninostri..,adhoccontrariis	locali regni nostri . . , ad hoc contrariis
,nonobstantibusquibuscunque;solvendonobis.	, non obstantibus quibuscunque ; solvendo nobis .
hacvicefinanciammoderatam	hac vice financiam moderatam
moderatam.Quocircadilectiset..fidelibusnostrisgentibuscompotorum	moderatam . Quocirca dilectis et . . fidelibus nostris gentibus compotorum
nostrorumetthesaurariis..Parisius,necnonsenescalloPictavie,ceterisque	nostrorum et thesaurariis . . Parisius , necnon senescallo Pictavie , ceterisque
ceterisqueomnibusetsingulisjusticiariisetofficiariisnostrisquibuscunque,	ceterisque omnibus et singulis justiciariis et officiariis nostris quibuscunque ,
auteorumlocatenentibus,presentibusetfuturis,eteorum	aut eorum locatenentibus , presentibus et futuris , et eorum
cuilibet,proutadeumpertinuerit	cuilibet , prout ad eum pertinuerit
,mandamusdistrictiusinjungendoquathinusprefatumAndream	, mandamus districtius injungendo quathinus prefatum Andream
deSanctoSebastianoetejusposteros	de Sancto Sebastiano et ejus posteros
posterosnostrispresentibuslegitimacione,	posteros nostris presentibus legitimacione ,
,concessioneetgraciautietgauderepacificefaciant	, concessione et gracia uti et gaudere pacifice faciant
etpermittant,absquequovisimpedimento,	et permittant , absque quovis impedimento ,
quodsiillatumforet,idreparentetad	quod si illatum foret , id reparent et ad
statumpristinumet	statum pristinum et
debitumreducant,seureducifaciant	debitum reducant , seu reduci faciant
indilate,	indilate ,
,visispresentibus.Quibus,..utperpetuestabilitatis	, visis presentibus . Quibus , . . ut perpetue stabilitatis
roburobtineant,nostrumjussimusapponisigillum	robur obtineant , nostrum jussimus apponi sigillum
sigillum.Nostroinaliisetomnibusquolibet	sigillum . Nostro in aliis et omnibus quolibet
alienojure	alieno jure
juresempersalvo.DatuminMontiliispropeTuronis,die	jure semper salvo . Datum in Montiliis prope Turonis , die
xxiiiiamensisfebruariiannoDominimillesimo	xxiiiia mensis februarii anno Domini millesimo
ccccmoquinquagesimoprimo,etregninostritricesimo.Sic	ccccmo quinquagesimo primo , et regni nostri tricesimo . Sic
signata:..	signata : . .
.Perregem,dominodeMontsoreauet	. Per regem , domino de Montsoreau et
aliispresentibus	aliis presentibus
presentibus.DeLaLoère.—Visa.	presentibus . De La Loère .— Visa .
