Philippus,regisFrancorumfilius,comesPictavensis	Philippus , regis Francorum filius , comes Pictavensis
Burgundiequepalatinusacdominus	Burgundieque palatinus ac dominus
deSalinis.Notumfacimusnosinfrascriptas.vidisse	de Salinis . Notum facimus nos infra scriptas . vidisse
litterasinhecverba:	litteras in hec verba :
Atouzceausquices	A touz ceaus qui ces
presenteslettresverrontet	presentes lettres verront et
etorront,nousGuiartleViconte	et orront , nous Guiart le Viconte
Viconte,chastelainde	Viconte , chastelain de
Benonetmestredeforeiznostresegneurleconte	Benon et mestre de foreiz nostre segneur le conte
dePoytiersenPoytoueten	de Poy tiers en Poytou et en
Xanctonge,et..jeEstiennePiolarsprocureurdu	Xanctonge , et . . je Estienne Piolars procureur du
du..ditconte,salut.Sachenttuit	du . . dit conte , salut . Sachent tuit
que,commelesreligieus.hommes,l	que , comme les religieus . hommes , l
'abbéet	' abbé et
etleconventdelaGracedeDieueussentacoustuméanciemiement	et le convent de la Grace de Dieu eussent acoustumé anciemiement
àprandreetàrecevoiren	à prandre et à recevoir en
laprevostédeBenonquarantelivresderentedoudon	la prevosté de Benon quarante livres de rente dou don
donàausfaitdouconteAlfons,jadis	don à aus fait dou conte Alfons , jadis
contedePoytiers,.çaenarriere,	conte de Poytiers , . ça en arriere ,
douquel	dou quel
ilontesté.	il ont esté .
ensaisineet.enpossessiondetantde	en saisine et . en possession de tant de
tempsquememoiredehommen'	temps que memoire de homme n '
estducontraire,sicommeilapparroitpar	est du contraire , si comme il apparroit par
boneslettres,..	bones lettres , . .
...etlesdizreligieus	. . . et les diz religieus
fussentvenushumblement	fussent venus humblement
humblementenrequerantànoblemonseigneurPierred'Arrebloy	humblement en requerant à noble monseigneur Pierre d ' Arrebloy
Arrebloy,chancelierdutrèsnoble	Arrebloy , chancelier du très noble
nobleprincemonseigneurlecontedePoytiers,	noble prince monseigneur le conte de Poytiers ,
duquelcontelachastelaniedeBenon,ensembleement	du quel conte la chastelanie de Benon , ensembleement
oulacontée,	ou la contée ,
avoitestéballieetassiseenson	avoit esté ballie et assise en son
sonpartagedemonseigneurLoys,roydeFrance	son partage de monseigneur Loys , roy de France
etdeNavarre,sonfrère,queledit	et de Navarre , son frère , que le dit
monseigneurleconteleurpaiastetrendistles	monseigneur le conte leur paiast et rendist les
ditesquarantelivres,	dites quarante livres ,
,sicommeilavoientacoustumé,oupleust	, si comme il avoient acoustumé , ou pleust
auditmonseigneurle.contebaillieraus	au dit monseigneur le . conte baillier aus
dizrelegieus.	diz relegieus .
.,tantdesesessarzenla	. , tant de ses essarz en la
forestdeBenon	forest de Benon
,auplusprèsde	, au plus près de
leurmesonde	leur meson de
de..Dardoi,queilfeussentsoitet	de . . Dardoi , que il feussent soit et
paiédesditesquarantelivresderente..Et	paié des dites quarante livres de rente . . Et
nous,lidizchanseliers,avon.	nous , li diz chanseliers , avon .
enclinéàlarequestedes	encliné à la requeste des
dizrelegieusetdonamesencommandementauditGuiartet	diz relegieus et donames en commandement au dit Guiart et
auditEstiennedessus	au dit Estienne dessus
nommez,lieu	nommez , lieu
lieutenantdoudit	lieu tenant dou dit
chastelain,queilbaillassenttantdesdiz	chastelain , que il baillassent tant des diz
dizessarzausdizrelegieusetèslieusdessusnommés	diz essarz aus diz relegieus et ès lieus dessus nommés
nommés,pour	nommés , pour
pourcincsolzchaiscunarpent	pour cinc solz chaiscun arpent
arpent,queles	arpent , que les
dizrelegieusfussentsolutetpaiédesditesquarante..livres	diz relegieus fussent solut et paié des dites quarante . . livres
derente.Et	de rente . Et
Etnous,	Et nous ,
leditchastelain	le dit chastelain
chastelain,et..	chastelain , et . .
.Estiennedessusnommez,	. Estienne dessus nommez ,
faisonsassavoir.	faisons assavoir .
àtousque,parlavertududitcommandement	à tous que , parla vertu du dit commandement
commandement,avonzbailliéaudizrelegieus	commandement , avonz baillié au diz relegieus
relegieus.,ensolucion	relegieus . , en solucion
etenpaiementdesditesquarantelivresderente	et en paiement des dites quaran te livres de rente
,septvinzetsezearpensdesdiz	, sept vinz et seze arpensdes diz
essars,chaiscunarpent	essars , chaiscun arpent
arpentpourlepris	arpent pour le pris
decincsolz,frans,	de cinc solz , frans ,
,quitesetdelivrésdetousdevoirs,de	, quites et delivrés de tous devoirs , de
toutesservitutes,	toutes servitutes ,
detousamortiemens,detoute	de tous amortiemens , de toute
financeetdetous	finance et de tous
tousautresdevoirs,.charges,côustumesetempechemenz,qui	tous autres devoirs , . charges , côustumes et empechemenz , qui
pournousporroientestreou	pour nous porroient estre ou
ànouspouroient	à nous pouroient
appartenir,toutevoie	appartenir , toute voie
retenuànousetausnoztouteiurisdicionèsdiz	retenu à nous et aus noz toute iurisdicion ès diz
dizlieus,saufausdizrelegieusque	diz lieus , sauf aus diz relegieus que
queilypuissentprendreetarrester	que il y puissent prendre et arrester
etvangier	et vangier
jusquesàseptsolz	jusques à sept solz
etdemisus..tousceausqui	et demi sus . . tous ceaus qui
quiforferontèsdizlieus,pourceque..les	qui forferont ès diz lieus , pour ce que . . les
lesdizlieussontloing	les diz lieus sont loing
loingdetoutesgens;regardé,consideré	loing de toutes gens ; regardé , consideré
etconseilliébienetloyaumentestreleprofistdu	et conseillié bien et loyaument estre le profist du
ditmonseigneurleconte,etappelez	dit monseigneur le conte , et appelez
plusieurspreudonmesdignesdefoy	plusieurs preudonmes dignes de foy
foy,jurezsus	foy , jurez sus
ceu,lesquauset	ceu , les quaus et
etchaiscunpoursoytesmongnerent	et chaiscun pour soy tesmongnerent
parleurssermensquelachoseestoitbienhaustement	par leurs sermens que la chose estoit bien haustement
baillié,etplusdistrentquenuluyne	baillié , et plus distrent que nuluy ne
voudroitquela	voudroit que la
chosefustseuepourlefuer.Etplusest	chose fust seue pour le fuer . Et plus est
assavoirque,commelesdiz..relegieusdeussent	assavoir que , comme les diz . . relegieus deussent
deussent,chaiscunan,[ou	deussent , chaiscun an ,[ ou
ou]chastiaudeBenon	ou ] chastiau de Benon
vintsolzderentepourune..piece	vint solz de rente pour une . . piece
deterreappeléel'essartRegnart,assise	de terre appelée l ' essart Regnart , assise
,prèsde	, près de
lormesondeDardoy,quelesdiz	lor meson de Dardoy , que les diz
vint..solzsontquiteetrabatu	vint . . solz sont quite et rabatu
doutouentout,enfaisantlabailletedes	dou tou en tout , en faisant la baillete des
dizessarz,etenontles	diz essarz , et en ont les
dizrelegieusmains	diz relegieus mains
mainsquatrearpenzpourlerabatdesdizvint	mains quatre arpenz pour le rabat des diz vint
solz;etyssiavoitestéparlé	solz ; et yssi avoit esté parlé
etacordéoutemps	et acordé ou temps
tempspasséoulesgenzleroy.	temps passé ou les genz le roy .
.Et.nousliabbezetliconvenzdessus	. Et . nous li abbez et li convenz dessus
dizfaisonassavoiràtousquenousavonpriset	diz faison assavoir à tous que nous avon pris et
etreceu..greaulablementles	et receu . . greaulablement les
essarzdessusdizetlasomme,enlafourme	essarz dessus diz et la somme , en la fourme
etenlamanierequedessus..estdit,et	et en la maniere que dessus . . est dit , et
etnouzentenismeset	et nouz en tenismes et
tenonsbienàpaiezpournouset	tenons bien à paiez pour nous et
pournossucesseurs,etpourceuque	pour nos sucesseurs , et pour ceu que
quenousyveismesleprofit	que nous y veismes le profit
denostreegliseapparessant.Etnouslesdizrelegieus	de nostre eglise apparessant . Et nous les diz relegieus
relegieusquietonetclamon.quicteauditmonseigneurPhelippe	relegieus quieton et clamon . quicte au dit monseigneur Phelippe
Phelippe,trèsexcellentprince,contedePoytiers,	Phelippe , très excellent prince , conte de Poy tiers ,
etàseshoirs	et à ses hoirs
etàsessucesseurs,età	et à ses sucesseurs , et à
à.tousceansquicauseauront	à . tous ceans qui cause auront
aurontdeausàtous.joursmais,lesdites	auront de aus à tous . jours mais , les dites
quarantelivresde..	quarante livres de . .
.rente,etquenousnelespuissonsjamais	. rente , et que nous ne les puissons jamais
demanderànul..	demander à nul . .
.temps,neproposer,nedirequenostre..	. temps , ne proposer , ne dire que nostre . .
diteeglize	dite eglize
eglizeyfustdeceue,etvoulonqueleschoses	eglize y fust deceue , et voulon que les choses
dessusditessoientfermesetestablezà	dessus dites soient fermes et establez à
àtouzjoursmais,entantcomme.	à touz jours mais , en tant comme .
ànouspuetappartenir.Et..nousGuiart	à nous puet appartenir . Et . . nous Guiart
,chastelain,etEstienne	, chastelain , et Estienne
Estiennedessusdizfaisonsassavoiràtouzquenous	Estienne dessus diz faisons assavoir à touz que nous
volonetconsenton,ennon	volon et consenton , en non
nondenostresegneurledit	non de nostre segneur le dit
conte,toutesleschoses	conte , toutes les choses
chosesdessusditesetchaiscuneparsoy,entantcomme	choses dessus dites et chaiscune par soy , en tant comme
iinouspuetappartenir,conme	ii nous puet appartenir , conme
àGuiart,chastelainetgarde	à Guiart , chastelain et garde
desforez,siconme.	des forez , si conme .
dessus.estdit,et	dessus . est dit , et
etàmoyEstienne	et à moy Estienne
EstiennePiolart,procureurdudit	Estienne Piolart , procureur du dit
ditmonseigneurleconte,pourlavertu	dit monseigneur le conte , pour la vertu
vertuducommandementdessusdit...	vertu du commandement dessus dit . . .
.Etengarentie	. Et en garentie
deverité,nousGuiarsetEstiennesdessus	de verité , nous Guiars et Estiennes dessus
dessusdizenavonsdonnéausdizreligieuscestepresentelettre	dessus diz en avons donné aus diz religieus ceste presente lettre
seeléedenospropresseiaus.,desquausnoususons	seelée de nos propres seiaus . , des quaus nous usons
,ensembleementouleseeldenostre	, ensembleement ou le seel de nostre
trèsnoble	très noble
segneurcontedePoytiers,establizenlachasteleniede..	segneur conte de Poytiers , establiz en la chastelenie de . .
Benon,liquelseelyaestéapposésà	Benon , li quel seel y a esté apposés à
larequeste	la requeste
requesteetàla..supplicaciondenous	requeste et à la . . supplicacion de nous
Guiart,chastelain,etEstiennedessusdiz.Et	Guiart , chastelain , et Estienne dessus diz . Et
nousMicheauBosseau,gardedouditseel,	nous Micheau Bosseau , garde dou dit seel ,
,àlarequesteetsupplicaciondouchastelainet	, à la requeste et supplicacion dou chastelain et
etEstiennes,dessusdiz,avonsapposéledit	et Estiennes , dessus diz , avons apposé le dit
ditseelàcestespresentes	dit seel à cestes presentes
lettres,en	lettres , en
plusgrant	plus grant
grantfermetédeverité.Etfu	grant fermeté de verité . Et fu
faitetdonné	fait et donné
lesamediemprès	le samedi emprès
emprèsNoëlTandegracemil	emprès Noël T an de grace mil
troiscensetquinze	trois cens et quinze
quinze.Nosautempredictaomniaetsingula	quinze . Nos autem predicta omnia et singula
singulainpredictiscontentalitteris..,proutcontentaetexpressain	singula in predictis contenta litteris . . , prout contenta et expressa in
inpredictislitterisexistunt,ratahabentes	in predictis litteris existunt , rata habentes
etgrata,ea	et grata , ea
volumus,laudamus	volumus , laudamus
etapprobamuseteciamconfirmamus.Salvo	et approbamus et eciam confirmamus . Salvo
inomnibusaliis..	in omnibus aliis . .
.jurenostrojurequequolibetalieno.In	. jure nostro jureque quolibet alieno . In
Incujusreitestimonium,sigillum	In cujus rei testimonium , sigillum
nostrumduximuslitterispresentibusapponendum,Actum	nostrum duximus litteris presentibus apponendum , Actum
Parisius,annoDominimillesimotrecentesimosexto	Parisius , anno Domini millesimo trecentesimo sexto
decimo,mense	decimo , mense
-novembris	- novembris
