Karolus,DeigraciaFrancorumrex	Karolus , Dei gracia Francorum rex
.Illegitime..genitos	. Illegitime . . genitos
genitosquosvitedecorat.honestas	genitos quos vite decorat . honestas
natureviciumminimedecolorat,namdecorvirtutisabscondit	nature vicium minime decolorat , nam decor virtutis abscondit
inprolemaculamgenitureet..pudiciciamorum	in prole maculam geniture et . . pudicicia morum
pudor.originisaboletur	pudor . originis aboletur
.Notumigiturfacimusuniversis,	. Notum igitur facimus universis ,
presentibusetfuturis,.quodlicet	presentibus et futuris , . quod licet
licetJohannesdeMay	licet Johannes de May
,filiusnaturalisSavarydeLaTour	, filius naturalis Savary de La Tour
etJohannedeLezay,ex	et Johanne de Lezay , ex
illicitacopulatraxeritoriginem,..videlicetexdictisSavaryde	illicita copula traxerit originem , . . videlicet ex dictis Savary de
LaTour.et	La Tour . et
JohannadeLezay,talibustamenvirtutisdonisetmorum	Johanna de Lezay , talibus tamen virtutis donis et morum
morumvenustateinsignitur,quodin	morum venustate insignitur , quod in
inipsosupplentmeritaetvirtutesidquodortus	in ipso supplent merita et virtutes id quod ortus
odiosusadjecit,	odiosus adjecit ,
,adeoquodsuperdeffectu.nataliumquempatitur	, adeo quod super deffectu . natalium quem patitur
,gratiamquam	, gratiam quam
nobishumilimepostulavitmeritodebet.obtinere.	nobis humilime postulavit merito debet . obtinere .
Hincestquodnos,hiisattentisnecnonaliquibus	Hinc est quod nos , hiis attentis nec non aliquibus
serviciisperipsumJohannemnobis	serviciis per ipsum Johannem nobis
nobisimpensis,ipsumJohannemdenostreregie	nobis impensis , ipsum Johannem de nostre regie
regiepotestatisplenitudineauctoritateque	regie potestatis plenitudine auctoritateque
regiaetgraciaspecialilegitimavimusetlegitimacionistitulo	regia et gracia speciali legitimavimus et legitimacionis titulo
titulodecoramusper	titulo decoramus per
presentes.;volentesutipse	presentes . ; volentes ut ipse
ipsedeinceps,injudicioetextra,pro	ipse deinceps , in judicio et extra , pro
legitimohabeatur,	legitimo habeatur ,
,aceidemconcedentes	, ac eidem concedentes
concedentesetcum	concedentes et cum
cumeodispensantesut,	cum eo dispensantes ut ,
quanquamipse	quanquam ipse
decohituillicitooriginemtraxerit,bonamobilia	de cohitu illicito originem traxerit , bona mobilia
mobiliatemporaliaquecumqueetinmobilia	mobilia temporalia quecumque et inmobilia
inmobiliaacquirereetjamacquisitaretinereetpacificepossidere	inmobilia acquirere et jam acquisita retinere et pacifice possidere
valeat,acdeeisdisponere	valeat , ac de eis disponere
disponereintervivosvelintestamento,adsuelibitum	disponere inter vivos vel in testamento , ad sue libitum
libitumvoluntatis,adsuccessionemquedictorum..patris	libitum voluntatis , ad successionemque dictorum . . patris
etmatrisceterorumqueparentumetamicorumcarnaliumsuorumetaliorum	et matris ceterorumque parentum et amicorum carnalium suorum et aliorum
quorumlibet,ex	quorumlibet , ex
testamentovelintestato,dummodode	testamento vel intestato , dummodo de
eorumprocesserit..voluntateetnisialteriforetjus	eorum processerit . . voluntate et nisi alteri foret jus
jamquesitum	jam quesitum
,etadquoscunque	, et ad quoscunque
honores,officiaet	honores , officia et
aliosactuslegitimosadmittaturacsiesset	alios actus legitimos admittatur ac si esset
essetdelegitimomatrimonioprocreatus;quodqueeciamsui	esset de legitimo matrimonio procreatus ; quodque eciam sui
liberi,..	liberi , . .
.siquos	. si quos
quosinfuturumhabeat,totaqueejusposteritasdelegitimo	quos in futurum habeat , totaque ejus posteritas de legitimo
legitimomatrimonioprocreandainbonissuisquibuscunqueeidemjure	legitimo matrimonio procreanda in bonis suis quibuscunque eidem jure
hereditariosuccedantetsuccederevaleant	hereditario succedant et succedere valeant
,..nisialiudquamdefectushujusmodi	, . . nisi aliud quam defectus hujusmodi
nataliumrepugnet,predicto..defectu	natalium repugnet , predicto . . defectu
defectuquemprorsusabolemus	defectu quem prorsus abolemus
,jure,constitucione	, jure , constitucione
,.statuto,edito,consuetudine	, . statuto , edito , consuetudine
consuetudine,usugeneralivellocaliregninostri	consuetudine , usu generali vel locali regni nostri
adhoccontrariisnonobstantibusquibuscunque,	ad hoc contrariis non obstantibus quibuscunque ,
solvendonobishac	solvendo nobis hac
vicefinanciammoderatam.Quocircadilectisetfidelibus	vice financiam moderatam . Quocirca dilectis et fidelibus
fidelibusgentibuscompotorum	fidelibus gentibus compotorum
nostrorumetthesaurariis,baillivisque	nostrorum et thesaurariis , baillivisque
TuronieetBitturie,necnon	Turonie et Bitturie , necnon
senescalloPictavensiceterisquejusticiariis	senescallo Pictavensi ceterisque justiciariis
etofficiariisnostris,.auteorum	et officiariis nostris , . aut eorum
locatenentibus,presentibus.etfuturis,	locatenentibus , presentibus . et futuris ,
,eteorumcuilibet,tenorepresentium	, et eorum cuilibet , tenore presentium
mandamusquatinusdictumJohannemdeMayetejusposteros	mandamus quatinus dictum Johannem de May et ejus posteros
nostrispresentibuslegitimacione,concessioneetgraciauti	nostris presentibus legitimacione , concessione et gracia uti
etgauderepacificefaciantetpermittant,absquequovisimpedimento	et gaudere pacifice faciant et permittant , absque quovis impedimento
.Quod,siillatumforet,idreparent	. Quod , si illatum foret , id reparent
reparentetadstatumpristinumetdebitumreducantseu	reparent et ad statum pristinum et debitum reducant seu
seureducifaciantindilate,visispresentibus.Quibus,ut	seu reduci faciant indilate , visis presentibus . Quibus , ut
stabilitatisperpetueroburobtineant,	stabilitatis perpetue robur obtineant ,
nostrumjussimusapponisigillum.Nostro	nostrum jussimus apponi sigillum . Nostro
Nostrotameninceteris	Nostro tamen in ceteris
etalienoinomnibusjuribussemper	et alieno in omnibus juribus semper
salvis.DatuminopidoVilleDei	salvis . Datum in opido Ville Dei
DeipropeSanctum.Maxencium,inmensenovembrisannoDomini	Dei prope Sanctum . Maxencium , in mense novembris anno Domini
millesimoquadringentesimo	millesimo quadringentesimo
quinquagesimoprimoetregninostritricesimo.Sicsignata	quinquagesimo primo et regni nostri tricesimo . Sic signata
:Perregem,	: Per regem ,
dominodeForesta,magistro	domino de Foresta , magistro
magistroStephanoMilitisetaliispresentibus.—Visa.	magistro Stephano Militis et aliis presentibus .— Visa .
