Charles,etc.Savoirfaisonsàtous,	Charles , etc . Savoir faisons à tous ,
presensetavenir,ànousavoirestéexposéde	presens et avenir , à nous avoir esté exposé de
delapartie	de la partie
partiedePierreAymon	partie de Pierre Aymon
que,commelejouraprèsNoelderrainement	que , comme le jour après Noel derrainement
passé,enla	passé , en la
villedel’Ermenauten	ville de l ’ Ermenaut en
Poitou,	Poitou ,
certaindebatetriotefeustmeueentreJehan	certain debat et riote feust meue entre Jehan
Garineau,d’unepart	Garineau , d ’ une part
,etRaoulCousson,commissaireàlever	, et Raoul Cousson , commissaire à lever
etcueillirenladictevilleune	et cueillir en la dicte ville une
uneaydeoctroyéeà	une ayde octroyée à
nostretrèschieretaméoncle	nostre très chier et amé oncle
oncleleducdeBerryet	oncle le duc de Berry et
d’Auvergne,contedePoitou,.etaucuns	d ’ Auvergne , conte de Poitou , . et aucuns
autres,d’autrepart,avintquele	autres , d ’ autre part , avint que le
ditexposantquiavoitàfemmelacousinegermaine	dit exposant qui avoit à femme la cousine germaine
germaineduditGarineau,pourbiendepaixet	germaine du dit Garineau , pour bien de paix et
amournatureledesondit	amour naturele de son dit
cousin,seadreçalàenvoulantapaisierlabesongne	cousin , se adreça là en voulant apaisier la besongne
besongne,dontilfistson.povoir;carcontreson	besongne , dont il fist son . povoir ; car contre son
ditcousinquitenoitungranttisondont	dit cousin qui tenoit un grant tison dont
ils’efforçoit	il s ’ efforçoit
devillenerle	de villener le
ditcommissaireetl’eust	dit commissaire et l ’ eust
eustfait,	eust fait ,
s’ileustpeu,leditexposant	s ’ il eust peu , le dit exposant
alaetsemistentredeux,	ala et se mist entre deux ,
endestournant..sonditcousinlemielxqu	en destournant . . son dit cousin le mielx qu
’ilpovoit.	’ il povoit .
.,afinqu’ilnevilennast	. , afin qu ’ il ne vilennast
leditcommissaire;etaprèspluseursparoleset	le dit commissaire ; et après pluseurs paroles et
amonnestemensqu’ilfistà	amonnestemens qu ’ il fist à
sonditcousin,afinqu’il	son dit cousin , afin qu ’ il
sedeportastdudit	se deportast dudit
commissairedenostre	commissaire de nostre
ditoncleinjurier,pourcequesondit	dit oncle injurier , pour ce que son dit
cousinn’y	cousin n ’ y
vouloitobeirettousjoursperseveroitets..’efforçoit	vouloit obeir et tousjours perseveroit et s . . ’ efforçoit
debatreledit.commissaire,	de batre le dit . commissaire ,
,ycelluiexposant,quicevouloit	, ycellui exposant , qui ce vouloit
eschever,prist	eschever , prist
etentretintàforcesondit	et entretint à force son dit
ditcousin,	dit cousin ,
lequelmeuzdemalvaisevolentéetpourcequele	lequel meuz de malvaise volenté et pour ce que le
ditexposant,pourbiende	dit exposant , pour bien de
paix,ledetenoit	paix , le detenoit
,etneluilaissoit	, et ne lui laissoit
faire.son	faire . son
malvaizpropos,atoutletisonqu’iltenoit	malvaiz propos , atout le tison qu ’ il tenoit
tenoitferyledit	tenoit fery le dit
ditexposantsurl’espaule,etrecouvradeuxfoys	dit exposant sur l ’ espaule , et recouvra deux foys
etlerefery	et le refery
surlatesteetsurlebras	sur la teste et sur le bras
,ettantque	, et tant que
ledit.exposantquise	le dit . exposant qui se
sentoitbatuzetvillenez,pourdoubte	sentoit batuz et villenez , pour doubte
doubtedepisavoir,leplustost	doubte de pis avoir , le plus tost
qu’ilpeust..s’enfuydevant	qu ’ il peust . . s ’ en fuy devant
sonditcousin,.	son dit cousin , .
.quidecenefu	. qui de ce ne fu
pascontens,.maizlepoursuychaudementet	pas contens , . maiz le poursuy chaudement et
demauvaizpropos	de mauvaiz propos
atoutle	atout le
dit.tison,jusquesà	dit . tison , jusques à
tantque.leditexposant,quipourbien	tant que . le dit exposant , qui pour bien
faireavoitainsiesté	faire avoit ainsi esté
batusetinjuriezetencoresestoitpoursuys	batus et injuriez et encores estoit poursuys
,ensoydeffendantetrepellantforceparforce	, en soy deffendant et repellant force par force
force,frapasonditcousin	force , frapa son dit cousin
cousind’unebarredeboisqu’	cousin d ’ une barre de bois qu ’
iltrouva,àquoyonfermoituneporte	il trouva , à quoy on fermoit une porte
,i.seulcop,dont	, i . seul cop , dont
aprèssonditcousinalade	après son dit cousin ala de
vie.àmort.Pouroccasionduquel	vie . à mort . Pour occasion du quel
quelfait,ledit	quel fait , le dit
exposant..doubterigueurde	exposant . . doubte rigueur de
justiceetn	justice et n
’.oseconverseraupays,en	’ . ose converser au pays , en
noushumblementsuppliant	nous humblement suppliant
suppliantcommeentous[autres]cas,	suppliant comme en tous [ autres ] cas ,
ilaitesté.et	il ait esté . et
etsoitde	et soit de
de.bonnevieetrenommée,ethonnesteconversacion,	de . bonne vie et renommée , et honneste conversacion ,
noussurceluivueillonsimpartirnostregrace	nous sur ce lui vueillons impartir nostre grace
.Nousadecertes,	. Nous adecertes ,
ceschosesconsiderées,voulansrigueur	ces choses considerées , voulans rigueur
dejusticetemperer	de justice temperer
demisericorde,lefaitdeladictemort	de misericorde , le fait de la dicte mort
ettoutepeine,offenseetamendecorporelle,	et toute peine , offense et amende corporelle ,
crimineleetcivile	criminele et civile
civile,que..leditexposanta	civile , que . . le dit exposanta
etpuetavoirpourcecommisetencouruoucas	et puet avoir pour ce commis et encouru ou cas
dessusdit,etsattisfaitàpartie	dessus dit , et sattisfait à partie
premierement,luiavonsquictié	premierement , lui avons quictié
,remisetpardonné,quictons	, remis et pardonné , quictons
quictons,remettons	quictons , remettons
remettonsetpardonnonsdenostre	remettons et pardonnons de nostre
auctoritéroyaletgraceespecial,enlerestituantà	auctorité royal et grace especial , en le restituant à
sabonnerenommée,se	sa bonne renommée , se
pourceenestoitamendrye	pour ce en estoit amendrye
,aupaysetàses.	, au pays et à ses .
.biens,quipar	. biens , qui par
banneseroientconfisquiez,etenimposant	ban ne seroient confisquiez , et en imposant
imposantsurtoutsilenceperpetuel.ànostreprocureurparcespresentes	imposant sur tout silence perpetuel . à nostre procureur par ces presentes
.Parlateneurdesquelles	. Par la teneur des quelles
quellesnousdonnonsen	quelles nous donnons en
enmandementaugouverneurdelaRochelleetàtouz	en mandement au gouverneur de la Rochelle et à touz
nozautresjusticiersetofficiers	noz autres justiciers et officiers
,presensetavenir,.ouà	, presens et avenir , . ou à
àleurslieuxtenans,etàchascund’eulx	à leurs lieuxtenans , et à chascun d ’ eulx
eulx,sicommeàluiappartendra,quedenostre	eulx , si comme à lui appartendra , que de nostre
nostrepresentegraceetremissionfacentetlaissentledit	nostre presente grace et remission facent et laissent le dit
exposantjoir	exposant joir
etuserpaisiblement	et user paisiblement
,sanzlemolesterne	, sanz le molester ne
empeschier,nesoufrirestremolestéouempeschiéaucunement	empeschier , ne soufrir estre molesté ou empeschié aucunement
,encorps	, en corps
neenbiens	ne en biens
biens,aucontraire;maistoutcequiseroit	biens , au contraire ; mais tout ce qui seroit
faitouattemptéàl’	fait ou attempté à l ’
encontremettentoufacentmettre,	encontre mettent ou facent mettre ,
,tantostetsanzdelay,aupremier	, tantost et sanz delay , au premier
premierestatet	premier estat et
deu.Etpourcequecesoitchoseferme	deu . Et pour ce que ce soit chose ferme
etestableàtousjoursmaiz,nousavonsfait	et estable à tousjours maiz , nous avons fait
mettrenostreseelordennéenl’absencedugrant	mettre nostre seel ordenné en l ’ absence du grant
àcespresentes	à ces presentes
.Saufenautreschosesnostredroitetl’	. Sauf en autres choses nostre droit et l ’
autruientoutes.DonnéàParis,ou	autrui en toutes . Donné à Paris , ou
moisdefevrierl’andegrace	mois de fevrier l ’ an de grace
gracemilccciiiixxetdeux,etde	grace mil ccc iiiixx et deux , et de
nostreregneletiers.Es	nostre regne le tiers . Es
requestesdel’ostel.G.	requestes de l ’ ostel . G .
deMezon	de Mezon
Mezon.—Robert.	Mezon .— Robert .
