Jehans,ainsnezfilzetlieutenans	Jehans , ainsnez filz et lieu tenans
du..royde	du . . roy de
France,ducdeNormandie.et	France , duc de Normandie . et
etde..Guienne,	et de . . Guienne ,
conte.dePoitou,d	conte . de Poitou , d
'AnjouetduMaine,àtous	' Anjou et du Maine , à tous
ceulz..qui	ceulz . . qui
ceslettresverront,salut	ces lettres verront , salut
salut.Nousavonzveuleslettresdenostre	salut . Nous avonz veu les lettres de nostre
améetfealconseiller,	amé et feal conseiller ,
,l'evesquedeBeauvez,contenans..	, l ' evesque de Beauvez , contenans . .
la.fourmequi	la . fourme qui
s'ensuit:Jehans..	s ' ensuit : Jehans . .
,parlagracedeDieu,evesquedeBeauvez	, par la grace de Dieu , evesque de Beauvez
,lieutenantdu	, lieutenant du
duroynostreseigneurèspartiesdelaLanguedocetde	du roy nostre seigneur ès parties de la Languedoc et de
Xanctonge,etdetrès	Xanctonge , et de très
excellentprincemonseigneur..	excellent prince monseigneur . .
Jehan,sonainsnéfilz	Jehan , son ainsné filz
,duc.deNormandie,	, duc . de Normandie ,
,contede	, conte de
Poitou,d'Anjou	Poitou , d ' Anjou
AnjouetduMaine,et	Anjou et du Maine , et
segneurdesterresdenouvelconquises	segneur des terres de nouvel conquises
conquisesèsditesparties,àtouzceulz	conquises ès dites parties , à touz ceulz
quicespresentes..lettresverront,	qui ces presentes . . lettres verront ,
,salut.Savoir.faisons	, salut . Savoir . faisons
nousavoirveules	nous avoir veu les
leslettresdenoblehommemessireYtier,segneur	les lettres de noble homme messire Ytier , segneur
deMaignac,chevalier,contenansla	de Maignac , chevalier , contenans la
fourmequis'ensuit:Atousceulzqui	fourme qui s ' ensuit : A tous ceulz qui
quicespresentes	qui ces presentes
lettresverront	lettres verront
,Ytier,segneurdeMaignac,	, Ytier , segneur de Maignac ,
,chevalierduroynostreseigneur,capitainesouverainde	, chevalier du roy nostre seigneur , capitaine souverain de
parlideputéenXanctonge	par li deputé en Xanctonge
,Poitou,Limosinetèsliexvoisins,	, Poitou , Limosin et ès liex voisins ,
,etseneschaldeXainctonge,salut.Nous	, et seneschal de Xainctonge , salut . Nous
Nousavonzreceuleslettresduroynostre	Nous avonz receu les lettres du roy nostre
seigneur,contenanslafourmequi	seigneur , contenans la fourme qui
quis'ensuit	qui s ' ensuit
:.Philipes,Philippes	: . Philipes , Philippes
,parlagracedeDieu,roys	, par la grace de Dieu , roys
roysdeFrance.	roys de France .
Atousceulxquiceslettres	A tous ceulx qui ces lettres
lettresverront,salut.	lettres verront , salut .
Commeautrefoisparnozlettres	Comme autrefois par noz lettres
aionzcommis	aionz commis
etdonnépovoirànostreaméetfealchevalier	et donné povoir à nostre amé et feal chevalier
chevalier,Itier,seigneurdeMaignac,nostrecapitaine..	chevalier , Itier , seigneur de Maignac , nostre capitaine . .
.souverainèspartiesdePoitou,Xainctonge	. souverain ès parties de Poitou , Xainctonge
Xainctonge,Limosinetèslieuxvoisins,de	Xainctonge , Limosin et ès lieux voisins , de
fairecertainzexplois,si	faire certainz explois , si
sicomplus	si com plus
àplainpeutapparoir.parnozditeslettres,	à plain peut apparoir . par noz dites lettres ,
etnousaionzentenduqueaucunsesontefforciéet	et nous aionz entendu que aucun se sont efforcié et
efforcentde	efforcent de
venirencontreleschosesàlicommisesetdenon	venir encontre les choses à li commises et de non
obéiràce	obéir à ce
,tantque	, tant que
,pourfautedeceulz,leditcapitaine	, pour faute de ceulz , le dit capitaine
capitaine.n'apeunepuetavoirdeniers	capitaine . n ' a peu ne puet avoir deniers
pourdistribuerausgenzd..'armes	pour distribuer aus genz d . . ' armes
armes,qu'il	armes , qu ' il
il.liconvientà	il . li convient à
teniràladeffensedupaïs;savoir	tenir à la deffense du païs ; savoir
faisonsqueàycelluiavonzdonnéetdonnonzplain	faisons que à ycellui avonz donné et donnonz plain
povoir,auctorité	povoir , auctorité
auctoritéetmandementespecialdefairenterineret	auctorité et man dement especial de fair enteriner et
acomplirtoutesleschosesetchascuned	acomplir toutes les choses et chascune d
'icelles,contenues	' icelles , contenues
etdeviséesennozdictes	et devisées en noz dictes
dicteslettres;eten	dictes lettres ; et en
oultre.lidonnonzpovoirdeanoblirpersonnesnon	oultre . li donnonz povoir de anoblir personnes non
nobles,enprenantoufaisant	nobles , en prenant ou faisant
prendrepournoustellescomposicionsoufinancescommeilverra	prendre pour nous telles composicions ou finances comme il verra
pourlemiex,etendonnerses	pour le miex , et en donner ses
lettresouvertes,lesquellesnousconfermerons	lettres ouvertes , les quelles nous confermerons
enlasdesoieeten	en las de soie et en
cirevert,toutesfois..que	cire vert , toutes fois . . que
mestiersera..Etvolonzquedes	mestier sera . . Et volonz que des
desacquezgeneraumentfaisparpersonnes	des acquez generaument fais par personnes
nonnoblesdepersonnesnobles.	non nobles de personnes nobles .
.ilpuisseprendrefinanceoucomposicion,pourveu	. il puisse prendre finance ou composicion , pourveu
qu'ilnes'entremettent	qu ' il ne s ' entremettent
entremettentoucognoissent	entremettent ou cognoissent
deschosesquitouchentlezcinquantismesourereban,	des choses qui touchent lez cinquantismes ou rereban ,
pourlefaitoucause	pour le fait ou cause
denozpresentesguerres,	de noz presentes guerres ,
nonobstantlettresempetrez..aucontraire.Mandonzà	non obstant lettres empetrez . . au contraire . Mandonz à
tousqueauditcapitaine,encefaisant	tous que au dit capitaine , en ce faisant
,obéissentetentendentdiligemment	, obéissent et entendent diligemment
.Etentesmoingdece,nousavonz	. Et en tesmoing de ce , nous avonz
avonzfaitmettrenostreseelnouvel	avonz fait mettre nostre seel nouvel
àceslettresenl'	à ces lettres en l '
absencedugrant	absence du grant
grant.DonnéàParis,leviije	grant . Donné à Paris , le viije
jourdeaoust,l'	jour de aoust , l '
andegracemilccc	an de grace mil ccc
ccc.xletc....Par	ccc . xl etc .... Par
Parlavertu	Par la vertu
etauctoritédez.quellezlettres,faisons	et auctorité dez . quellez lettres , faisons
savoiràtous,presenset	savoir à tous , presens et
avenir,quepour	avenir , que pour
lesbonsetagreables	les bons et agreables
agreablesservices..quemaistreLorensPoussart	agreables services . . que maistre Lorens Poussart
Poussart,clerc	Poussart , clerc
,sageendroit	, sage en droit
,bourgoisdelaRochelle	, bourgois de la Rochelle
,afaitauroynosegneur,	, a fait au roy nosegneur ,
,enofficede	, en office de
delieutenant	de lieu tenant
,tantdenos	, tant de nos
nospredecesseurs.seneschausquedenous,par	nos predecesseurs . seneschaus que de nous , par
lonctemps,.sans	lonc temps , . sans
sansenavoiraucunpourfit,dontsommezplainnierement	sans en avoir aucun pourfit , dont sommez plainnierement
enformezleroynoseigneur	enformez le roy noseigneur
,pourlabonnediligence,avoirheupluseurspourfis	, pour la bonne diligence , avoir heu pluseurs pourfis
,consideranslabonneaffectionetvolenté	, considerans la bonne affection et volenté
qu'ilaaudit..segneurdele	qu ' il a au dit . . segneur de le
servir,etsertcontinuelement,etqueil	servir , et sert continuelement , et que il
agrandement	a grandement
prestédusienencesteguerre,etàl	presté du sien en ceste guerre , et à l
'aideetbesoingduditseignieur	' aide et besoing du dit seignieur
,nousvoulans	, nous voulans
yceulsservicescompenseretretribuerauditmaistreLorens	yceuls services compenser et retribuer au dit maistre Lorens
,entelemanierequecesoit	, en tele maniere que ce soit
soitàl..'onneur	soit à l . . ' onneur
etpourfitdeluiet	et pourfit de lui et
detoutesaposterité	de toute sa posterité
posterité,lequel,combienqu'ilne	posterité , le quel , combien qu ' il ne
soitd'aucun	soit d ' aucun
costéestraitdenoblelignye,toutez	costé estrait de noble lignye , toutez
fois,pourlessens,honnestezetbonnez	fois , pour les sens , honnestez et bonnez
œuvrezdeli,	œuvrez de li ,
estdignezdetoutehonneur	est dignez de toute honneur
,sicommenous[est]certefiépar	, si comme nous [ est ] certefié par
dignezdefoy.Pourconsiderationdesquelles	dignez de foy . Pour consideration des quelles
quelleschoses,denostrepovoir,auctoritécommiseetde	quelles choses , de nostre povoir , auctorité commise et de
decertainescience,yceluimaistreLorens..ettoussesenfanz	de certaine science , ycelui maistre Lorens . . et tous ses enfanz
enfanznezetànaistre,et	enfanz nez et à naistre , et
leurposteritétouteanoblissons,pronuncions,decernons	leur posterité toute anoblissons , pronuncions , decernons
etfaisonsnoblezet..pournoblezles	et faisons noblez et . . pour noblez les
tenons,etvoulonsetcommandonsestretenus	tenons , et voulons et commandons estre tenus
detousdesorendroit,àtousjoursmais.Et	de tous desorendroit , à tous jours mais . Et
voulonset.octroionsàlui,denostre	voulons et . octroions à lui , de nostre
ditpovoir,auctoritéetcertainescience,quetoutez	dit povoir , auctorité et certaine science , que toutez
toutezfoisqu'illiplairaetà	toutez fois qu ' il li plaira et à
sesdiz..enfanz,	ses diz . . enfanz ,
nezetànaistre,	nez et à naistre ,
ouàl'un	ou à l ' un
d'eulz,ou	d ' eulz , ou
deleurposterité	de leur posterité
,ilpuissentdemander,recevoir	, il puissent demander , recevoir
etobtenirde	et obtenir de
dequelconquepersonnenobleordredechevalerie,etde	de quelconque personne noble ordre de chevalerie , et de
touslesprevileges,imunitez,libertezetfranchises,	tous les previleges , imunitez , libertez et franchises ,
,dontliautrenobleusentetjoissent,le	, dont li autre noble usent et joissent , le
ditmaistre	dit maistre
Lorenz,sesdizenfanzettoute	Lorenz , ses diz enfanz et toute
touteleurposterité	toute leur posterité
usentaussietjoissentdesoresenavant	usent aussi et joissent des ores en avant
avantpaisiblementetàtousjours,envers	avant paisiblement et à tous jours , envers
tousetcontretous.,eten	tous et contre tous . , et en
touscas,et	tous cas , et
tiengnentleursfiez,rentes	tiengnent leurs fiez , rentes
rentes,terres,possessionset.	rentes , terres , possessions et .
autreschoses,	autres choses ,
acquisesetàaquerir.,denoblez	acquises et à aquerir . , de noblez
enfoyetenhommage,ouautre	en foy et en hommage , ou autre
segnouriefranchementetnoblement	segnourie franchement et noblement
,sanzcequeeulx	, sanz ce que eulx
,ouaucund'eulz	, ou aucun d ' eulz
,soient,nepuissentoudoientestre	, soient , ne puissent ou doient estre
contraintnetenuz	contraint ne tenuz
tenuzàlesmettre,entoutouenpartie	tenuz à les mettre , en tout ou en partie
partie,horsdeleursmainz,	partie , hors de leurs mainz ,
neàfaire	ne à faire
faireoupaierpour	faire ou paier pour
ce.aucune	ce . aucune
finance,	finance ,
ouredevancequelconque,auroynoseigneur	ou redevance quelconque , au roy noseigneur
neàsessuccesseurs,	ne à ses successeurs ,
roisdeFrance,neàautre,pour	rois de France , ne à autre , pour
nomdeeulz,ettoutefinanceetautreredevance	nom de eulz , et toute finance et autre redevance
redevancequiporroitestredeueauroynostreseigneur,	redevance qui porroit estre deue au roy nostre seigneur ,
ouautrementappartenirli..	ou autrement appartenir li . .
porroit,ouàses..successeurs,pourraisondes	porroit , ou à ses . . successeurs , pour raison des
chosesacquisesouàaquerreparledit	choses acquises ou à aquerre par le dit
maistreLorens,ouaucundesesdiz	maistre Lorens , ou aucun de ses diz
enfanz,oudeleur..posterité,ensambleoupar	enfanz , ou de leur . . posterité , ensamble ou par
parties,leurremettonzetquictons	parties , leur remettonz et quictons
dutout.Simandonsetcommandonsàtousles	du tout . Si mandons et commandons à tous les
lessubgiez,justiciersetsoumisduroynostreseigneur,	les subgiez , justiciers et soumis du roy nostre seigneur ,
dequelconquespovoirouauctoritéqueilusent	de quelconques povoir ou auctorité que il usent
usent,qui	usent , qui
quiàpresentsont,ou	qui à present sont , ou
quipourletempsà	qui pour le temps à
venirseront,età	venir seront , et à
chascund'eulz	chascun d ' eulz
,quecontrelateneurdenoz	, que contre la teneur de noz
presenteslettresneattemptent,procurentoufacent	presentes lettres ne attemptent , procurent ou facent
facentaucunechose,maislesexequtentetgardentde	facent aucune chose , mais les exequtent et gardent de
pointenpoint,chascunendroitsoy,	point en point , chascun en droit soy ,
sanzenfraindre...Etquece	sanz enfraindre . . . Et que ce
soitfermechoseetestableoutempsavenir	soit ferme chose et estable ou temps avenir
perpetuelement,nousavonz..fait	perpetuelement , nous avonz . . fait
mettreàcespresenteslettresle	mettre à ces presentes lettres le
leseeldela	le seel de la
dicteseneschauciedeXainctonge.Retenueentoutla	dicte seneschaucie de Xainctonge . Retenue en tout la
lavolentéduroynostreseigneuràconfermercespresentes	la volenté du roy nostre seigneur à confermer ces presentes
presentes,àsonbonplaisir.	presentes , à son bon plaisir .
DonnéàPons,leviijejourdeseptembre,l	Donné àPons , le viije jour de septembre , l
'andegrace..	' an de grace . .
milccc.xliiij.Nousadecertesleslettresdessus	mil ccc . xliiij . Nous adecertes les lettres dessus
transcriptesettoutesleschosescontenuesenycelles,	transcriptes et toutes les choses contenues en ycelles ,
,etchascuned'icelles..parsoy	, et chascune d ' icelles . . par soy
,aianzagreables,lesditeslettresettoutes	, aianz agreables , les dites lettres et toutes
leschosescontenuesenycellesvolonz,	les choses contenues en ycelles volonz ,
greonz,approuvonzetdel	greonz , approuvonz et de l
'.auctoritéroyaletdenostreditseigneur,monseigneur	' . auctorité royal et de nostre dit seigneur , monseigneur
leduc,à	le duc , à
nousdonnée,degraceespecial,confermonspar	nous donnée , de grace especial , confermons par
cespresenteslettres;les	ces presentes lettres ; les
quelesnousvolonsavoirautantdeforce	queles nous volons avoir autant de force
etvertu,.commeseelles	et vertu , . comme se elles
estoientpasséesetdelivrées	estoient passées et delivrées
plainementenla.chambredesComptes	plainement en la . chambre des Comptes
duroynostreseigneur,	du roy nostre seigneur ,
,etdemonseigneurleduc	, et de monseigneur le duc
,sonditfilz,àParis.Et	, son dit filz , à Paris . Et
pourcequecesoitfermechose	pour ce que ce soit ferme chose
etestable	et estable
,nousavonz	, nous avonz
faitmettrenostre	fait mettre nostre
seelàcespresenteslettres.Saufenautreschoses	seel à ces presentes lettres . Sauf en autres choses
ledroitdu	le droit du
duroynoseigneuretl'autruy	du roy noseigneur et l ' autruy
autruyentoutes.	autruy en toutes .
.Donnéàl'Ospital	. Donné à l ' Ospital
delezBourcneuf	de lez Bourcneuf
Bourcneuf,l'anmil	Bourcneuf , l ' an mil
ccc.xl.	ccc . xl .
etquatre,oumoys..denovembre.	et quatre , ou moys . . de novembre .
Nousadecertesaianztoutes	Nous adecertes aianz toutes
leschosescontenueséslettresdessustranscriptesfermesetagreables	les choses contenues és lettres dessus transcriptes fermes et agreables
agreables,toutesycelleschosesetchascuned	agreables , toutes ycelles choses et chascune d
d'icellesparsoy,de	d ' icelles par soy , de
l'auctoritéet..pouvoirroyaulzànous	l ' auctorité et . . pouvoir royaulz à nous
donnez,	donnez ,
volonz,	volonz ,
loonz,rattiffionz,	loonz , rattiffionz ,
approuvonzetdecertainescience	approuvonz et de certaine science
scienceetgraceespecial,.par	science et grace especial , . par
cespresentes	ces presentes
,confermonz.Saufen	, confermonz . Sauf en
autreschosesledroitdenostreditseigneur	autres choses le droit de nostre dit seigneur
seigneuretdenous,eten	seigneur et de nous , et en
entoutesl'autruy.Et	en toutes l ' autruy . Et
Etpourcequecesoitfermechoseestable	Et pour ce que ce soit ferme chose estable
àtousjours	à tous jours
,nousavonsfaitmettrenostre	, nous avons fait mettre nostre
seelàcespresenteslettres.Donné	seel à ces presentes lettres . Donné
àAngolesme,l'	à Angolesme , l '
anmilccc.quarante	an mil ccc . quarante
etcinq,ou	et cinq , ou
moysdenovembre.	moys de novembre .
Parmonseigneur	Par monseigneur
leduc,à	le duc , à
àlarelacionduconseil	à la relacion du conseil
l'auvousesties.J.d'	l ' au vous esties . J . d '
'Ailly.	' Ailly .
