Charles,etc.Savoirfaisonsàtous,presens	Charles , etc . Savoir faisons à tous , presens
presensetavenir,nousavoir.receul	presens et avenir , nous avoir . receu l
’umblesupplicaciondeColasde	’ umble supplicacion de Colas de
laRoche,escuier,natifdelachastellenie	la Roche , escuier , natif de la chastellenie
deMontaguen	de Montagu en
Poictou,aagédevintansouenviron,	Poictou , aagé de vint ans ou environ ,
filzdeAymeridelaRoche,escuier	filz de Aymeri de la Roche , escuier
,contenantque,	, contenant que ,
lelundiaprèslafestedeNoelderrenierementpassée	le lundi après la feste de Noel derrenierement passée
,iletJehandeMassoingnes,..qui	, il et Jehan de Massoingnes , . . qui
ont..acoustumédesuirlesguerres,	ont . . acoustumé de suir les guerres ,
separtirentdelavillede	se partirent de la ville de
Partenay,	Partenay ,
enlaqueleilzestoientlorsen	en la quele ilz estoient lors en
garnison,	garnison ,
et..setransporterentou	et . . se transporterent ou
villaiged’	villaige d ’
’Argentinesenl’..osteldeJehan	’ Argentines en l ’ . . ostel de Jehan
Roquin,seigneurd’iceluilieu	Roquin , seigneur d ’ icelui lieu
,et.enicelui	, et . en icelui
hostelsoupperentetcouscherent.Etlelendemainau	hostel soupperent et couscherent . Et le lendemain au
matin,s’enpartirentetalerenteulx	matin , s ’ en partirent et alerent eulx
deuxouvillaigedeCraon,auquelle	deux ou villaige de Craon , auquel le
ditsuppliantavoit,longtempsestoit,laissié	dit suppliant avoit , long temps estoit , laissié
unchevalmalade,eten	un cheval malade , et en
celleentencionyaloit.	celle entencion y aloit .
,eteulxestans.	, et eulx estans .
.ilecques,	. ilecques ,
arriverentausoirbientartAymerides	arriverent au soir bien tart Aymeri des
desPlaz,Oudinet	des Plaz , Oudinet
OudinetdeLaGrangeetunappelléCharon	Oudinet de La Grange et un appellé Charon
,quidistrentàiceluisuppliantqu’	, qui distrent à icelui suppliant qu ’
ilconvenoitqu’ilalastavecqueseulx	il convenoit qu ’ il alast avecques eulx
auprèsdeLodun,enl’ostel	auprès de Lodun , en l ’ ostel
d’ungentilhomme,	d ’ un gentilhomme ,
pourleprendreàprisonnier,	pour le prendre à prisonnier ,
,etqu’ilyavoittrès..bon	, et qu ’ il y avoit très . . bon
bonbutin.A.	bon butin . A .
quoyleditsuppliantquiestjeune	quoy le dit suppliant qui est jeune
escuierseaccordadelegier	escuier se accorda de legier
.Etlelendemainquifu	. Et le lendemain qui fu
lemercredi,setransporterentluiet	le mercredi , se transporterent lui et
lesdessusnommez,oulesaucunsd’iceulx	les dessus nommez , ou les aucuns d ’ iceulx
,enl’ostel	, en l ’ ostel
duditgentilhommeoud	du dit gentilhomme ou d
d’autredontil	d ’ autre dont il
nescetlenom,maisilzn	ne scet le nom , mais ilz n
n’ytrouverentluy	n ’ y trouverent luy
luyneaucuns..biens	luy ne aucuns . . biens
biens.Etcefait,..s’enpartirent,	biens . Et ce fait , . . s ’ en partirent ,
luietsesdizcompaignons,et	lui et ses diz compaignons , et
levendrediensuivantarriverent,soupperentetcouscherent	le vendredi ensuivant arriverent , soupperent et couscherent
endeux..hostelleries	en deux . . hostelleries
,enunlieu.appelléBethleem,	, en un lieu . appellé Bethleem ,
ettroisheures..	et trois heures . .
ouenviron..aprèsce	ou environ . . après ce
qu’ilzfurentcouchez,unvarletdeleur	qu ’ ilz furent couchez , un varlet de leur
compaigniealadireauditsuppliantetà	compaignie ala dire au dit suppliant et à
ceulxquiestoientavecquesluyqu’ilz	ceulx qui estoient avecques luy qu ’ ilz
ilzselevassentetqu’ilyavoit	ilz se levassent et qu ’ il y avoit
gensprès	gens près
d’illecquipassoientà	d ’ illec qui passoient à
cheval.Etlorsilzseleverent	cheval . Et lors ilz se leverent
leverent,monterentàchevaletalerenten	leverent , monterent à cheval et alerent en
enunchampassezprès,oùilztrouverentdeuxprestres	en un champ assez près , où ilz trouverent deux prestres
etunautrehommequis’en	et un autre homme qui s ’ en
aloientensemble,lesquelzilzprindrentet	aloient ensemble , lesquelz ilz prindrent et
etemmenerentavecqueseulxauditlieu	et emmenerent avecques eulx au dit lieu
lieudeBethleemouquel	lieu de Bethleem ouquel
ilzestoient,et	ilz estoient , et
lesdestrousserent,	les destrousserent ,
c’.estassavoirleditsuppliantl	c ’ . est assavoir le dit suppliant l
’undesdiz	’ un des diz
dizprestres,auquelilostaquarentesolztornois	diz prestres , auquel il osta quarente solz tornois
,etsesdizcompaignonsluyosterentsesbotes	, et ses diz compaignons luy osterent ses botes
ouhouseaux,sesesperonset	ou houseaux , ses esperons et
uneschaussesde.brunettetoutes	unes chausses de . brunette toutes
neufves.Etavecce	neufves . Et avec ce
celeditOdinet	ce le dit Odinet
deLaGrangeostaàl’	de La Grange osta à l ’
’ostedel’ostellerie,enlaquele	’ oste de l ’ ostellerie , en la quele
ilzestoientlogiez,	ilz estoient logiez ,
,lasommedequinze	, la somme de quinze
quinzesolztournoisquelefrereduditprestreluy	quinze solz tournois que le frere du dit prestre luy
avoitbaillezengarde	avoit baillez en garde
garde,pour.	garde , pour .
escheverqu	eschever qu
’ilzneluyfeussentostez	’ ilz ne luy feussent ostez
ostez.Etpourcequeiceluyhoste	ostez . Et pour ce que iceluy hoste
estoitrefusant.delesbailler	estoit refusant . de les bailler
,leditOdinet	, le dit Odinet
Odinetlebaty...Etaprès	Odinet le baty . . . Et après
ce,pourcequeleditsuppliantet	ce , pour ce que le dit suppliant et
iceulxdesacompaigniecuidoientqueledit	iceulx de sa compaignie cuidoient que le dit
ditprestrepareulxainsidestroussé	dit prestre par eulx ainsi destroussé
destroussé,commeditest	destroussé , comme dit est
,eustencoresautreargent,	, eust encores autre argent ,
,ilzlemenerentenl’ostellerieoùestoientlogiez	, ilz le menerent en l ’ ostellerie où estoient logiez
leursautrescompaignonsetlesfirentleverdeleursliz	leurs autres compaignons et les firent lever de leurs liz
,firentdespoillerledit	, firent despoiller le dit
ditprestreetlesercherent,etpareulxtrouvé	dit prestre et le sercherent , et par eulx trouvé
trouvéqu’iln	trouvé qu ’ il n
n’avoitplusd’	n ’ avoit plus d ’
argent..,	argent . . ,
lelaisserentaler.Et	le laisserent aler . Et
d’ilec..setransporterent	d ’ ilec . . se transporterent
àAuzance..prèsdePoictiers	à Auzance . . près de Poictiers
,enesperancedetrouverdesBretons.pour	, en esperance de trouver des Bretons . pour
pourlesdestrousseretprendreàprisonniers.Ouquellieuilz	pour les destrousser et prendre à prisonniers . Ouquel lieu ilz
prindrentungentilhomme..quiest	prindrent un gentil homme . . qui est
estàl’evesquedePoictiers,enentencionde	est à l ’ evesque de Poictiers , en entencion de
l’enemmenerprisonnieravecqueseulx,et	l ’ en emmener prisonnier avecques eulx , et
lui.osterent	lui . osterent
osterentsonespée,sadagueetson	osterent son espée , sa dague et son
sonchevaldepoilgris,celleet	son cheval de poil gris , celle et
bridedupris	bride du pris
dexxv..escusd’	de xxv . . escus d ’
orouenviron;mais	or ou environ ; mais
ainsiqu’ilzsemettoientauchemin	ainsi qu ’ ilz se mettoient au chemin
pouremmenerledithomme,pluseursgensdesvilles	pour emmener le dit homme , pluseurs gens des villes
survindrentàpierresetàgros	survindrent à pierres et à gros
bastons,etlerescouyrent.Etpource,	bastons , et le rescouyrent . Et pour ce ,
,leditsuppliantet.	, le dit suppliant et .
sesdizcompaignons	ses diz compaignons
enemporterentetemmenerentcequeosté	en emporterent et emmenerent ce que osté
ostéluiavoient	osté lui avoient
,ets’enalerentlogier	, et s ’ en alerent logier
ès..faulxbourgsduditlieu	ès . . faulxbourgs du dit lieu
dePoictiers.Pouroccasiondes	de Poictiers . Pour occasion des
desquelzcas,le..ditsuppliantquiabon	des quelz cas , le . . dit suppliant qui a bon
propoxetvoulentédenonjamaisyrancheoirneen	propox et voulenté de non jamais y rancheoir ne en
autresmauvais[cas	autres mauvais [ cas
],..doubte	], . . doubte
estregriefmentpuny,separ	estre griefment puny , se par
nousneluiestsurceimpartie	nous ne lui est sur ce impartie
impartienostregrace	impartie nostre grace
etmisericorde,	et misericorde ,
sicommeildit,	si comme il dit ,
supplianthumblementque,commeau	suppliant humblement que , comme au
tempsqu’ilparti	temps qu ’ il parti
partipouralerveoirsonditchevalou	parti pour aler veoir son dit cheval ou
ditvillaigedeCraon..	dit villaige de Craon . .
,iln’eustaucuneentenciond’aler	, il n ’ eust aucune entencion d ’ aler
alerèsautres.lieux	aler ès autres . lieux
lieuxdessusdiznedecommettreaucuns	lieux dessus diz ne de commettre aucuns
mauvaiscas,et	mauvais cas , et
qu’ilest	qu ’ il est
jeuneescuieretdelegierfudeceuparles	jeune escuier et de legier fu deceu par les
dizcompaignons,etqueen	diz compaignons , et que en
commettantlescasdevantdizn’aeuaucune	commettant les cas devant diz n ’ a eu aucune
aucunemutilacionneautregriefvebateure,etque	aucune mutilacion ne autre griefve bateure , et que
lesdictes	les dictes
chosesparluietses	choses par lui et ses
dizcompaignonsprisesnemontoientpas.àgrantchose,	diz compaignons prises ne montoient pas . à grant chose ,
etque,commedit	et que , comme dit
est,le.ditsuppliant	est , le . dit suppliant
abonproposet	a bon propos et
etentenciondenonjamaiscommettreaucunstelzne	et entencion de non jamais commettre aucuns telz ne
neautresmauvaiscas,que	ne autres mauvais cas , que
nosdictes.	nos dictes .
graceetmisericordenousluivueillions	grace et misericorde nous lui vueillions
vueillionsimpartir.Pourquoynous,	vueillions impartir . Pour quoy nous ,
eueconsideracionauxchosesdessus	eue consideracion aux choses dessus
dessusdictesetaux.	dessus dictes et aux .
.bonsetnotablesservicesqueleperedudit	. bons et notables services que le pere du dit
suppliantetsespredecesseursnous	suppliant et ses predecesseurs nous
nousontfaiz,ou.tempspassé,ou	nous ont faiz , ou . temps passé , ou
faitdenozguerres,et	fait de noz guerres , et
aleditsuppliantentenciondefaireoutemps	a le dit suppliant entencion de faire ou temps
tempsavenir,	temps avenir ,
voulansmisericorde	voulans misericorde
misericordeestrepreferéeàrigueurde	misericorde estre preferée à rigueur de
dejustice,àiceluisuppliantoucasdessus	de justice , à icelui suppliant ou cas dessus
ditavonsquicté,.remiset	dit avons quicté , . remis et
pardonné,..etc.,	pardonné , . . etc .,
pourveutoutes	pourveu toutes
voyesqueiceluisuppliant	voyes que icelui suppliant
jureraetaffermeraparserementsolennelnesoy	jurera et affermera par serement solennel ne soy
armerdoresenavantavecceulxdeladicte	armer dores en avant avec ceulx de la dicte
garnisondePartenay,sanz	garnison de Partenay , sanz
nostrecongiéetlicence.Sidonnonsen	nostre congié et licence . Si donnons en
enmandement..ànostrebaillidesressorset	en mandement . . à nostre bailli des ressors et
etExempcionsdeTouraine,d’Anjou,dePoictou	et Exempcions de Touraine , d ’ Anjou , de Poictou
etduMaine,etàtouz.nozautresjusticiers	et du Maine , et à touz . noz autres justiciers
,etc.DonnéàParis	, etc . Donné à Paris
,oumoisdejanvierl’	, ou mois de janvier l ’
’andegracemilcccc.etdixsept	’ an de grace mil cccc . et dix sept
,etdenostreregnelexxxviiime.Parle	, et de nostre regne le xxxviiime . Par le
roy,messireJacquesdeMontmoret	roy , messire Jacques de Montmor et
etautrespresens.P.	et autres presens . P .
Nantron.	Nantron .
