Charles,etc....Savoirfaisonsà	Charles , etc . ... Savoir faisons à
tous,presensetavenir.,quecommenostre	tous , presens et avenir ., que comme nostre
trèschierettrèsaméfrereLoys,	très chier et très amé frere Loys ,
ducd'AnjouetconteduMaine	duc d ' Anjou et conte du Maine
Maine,pardondenostretrès..chierseigneuret	Maine , par don de nostre très . . chier seigneur et
etpere,queDieuabsoille,àlifait	et pere , que Dieu absoille , à li fait
,outemps.qu'ilvivoit	, ou temps . qu ' il vivoit
,eustettenistheritablement,perpetuelmenlet	, eust et tenist heritablement , perpetuelmenl et
àtousjours	à tous jours
,pourli	, pour li
,ses..hoirsetsuccesseursetaians	, ses . . hoirs et successeurs et aians
causedeli,lechastel..	cause de li , le chastel . .
etchastelleriedeChastouceauxettouteslesrentez,revenues	et chastellerie de Chastouceaux et toutes les rentez , revenues
,appartenanceset..appendancesd'iceulzchasteau	, appartenances et . . appendances d ' iceulz chasteau
etchastellerie,	et chastellerie ,
,etparle	, et par le
traictiéetpaixdeBretaignelesdizchasteauet	traictié et paix de Bretaigne les diz chasteau et
chastellerie,avecles	chastellerie , avec les
lesrevenus,rentes,appartenancesetappendancesdessusdites,	les revenus , rentes , appartenances et appendances dessus dites ,
deussentestrerendusetdelivrezentierement	deussent estre rendus et delivrez entierement
ànostretrèschieretfealcousin	à nostre très chier et feal cousin
leducdeBretaigne	le duc de Bretaigne
;pourquoynous,enacomplissantle	; pour quoy nous , en acomplissant le
ledittraictié..,	le dit traictié . . ,
aienzvoluquenostreditfrere	aienz volu que nostre dit frere
frerenousaitbailliéetrendulesdis	frere nous ait baillié et rendu les dis
dischasteletchastelleriepour	dis chastel et chastellerie pour
yceulzbailleretdelivrerànostreditcousin;la	yceulz bailler et delivrer à nostre dit cousin ; la
quellechosenostreditfrere,enobeissant	quelle chose nostre dit frere , en obeissant
ànostrecommandement..et	à nostre commandement . . et
etvolenté,a	et volenté , a
afaitetoctroyéliberalment	a fait et octroyé liberalment
liberalment,etyceulzchasteauetchastellerieavons	liberalment , et yceulz chasteau et chastellerie avons
realmentetdefaitfaitdelivrerànostreditcousin	realment et de fait fait delivrer à nostre dit cousin
.Nous,consideréelabonneobeissancedenostredit	. Nous , considerée la bonne obeissance de nostre dit
frere,àicellui,enlieu	frere , à icellui , en lieu
etrecompensacion.desdizchastel	et recompensacion . des diz chastel
etchastellerie,appartenanceset	et chastellerie , appartenances et
appendancesdeChastouceaux,avonsdonné,	appendances de Chastouceaux , avons donné ,
baillié,cedé,transferé,et	baillié , cedé , transferé , et
etdeleissié,etdegraceespecial,certainescienceet	et deleissié , et de grace especial , certaine science et
auctoritéetplainepuissanceroiaulz,donnons,baillons,	auctorité et plaine puissance roiaulz , donnons , baillons ,
cedons,delaissonsettransportonslechastelet	cedons , delaissons et transportons le chastel et
chastelleriedeLodun,	chastellerie de Lodun ,
avectoutes	avec toutes
touteslesnobleces,dignitez,	toutes les nobleces , dignitez ,
seigneuries,hommages,fiez..,arrerefiez,	seigneuries , hommages , fiez . . , arrerefiez ,
bois,eaues,molins,prez,rentes	bois , eaues , molins , prez , rentes
rentesendeniers,engrains,enoiseauz,et	rentes en deniers , en grains , en oiseauz , et
autresquelconquesrenteset.	autres quelconques rentes et .
revenues,appartenancesetappendancesd'iceulzchastelet	revenues , appartenances et appendances d ' iceulz chastel et
etchastellerie,quellesqueelles	et chastellerie , quelles que elles
ellessoientnecommentetoùqueellessoient	elles soient ne comment et où que elles soient
nomméesetassises,àteniriceulzchastelet	nommées et assises , à tenir iceulz chastel et
chastellerieavectouteslesrenteset..revenuesd'iceulz	chastellerie avec toutes les rentes et . . revenues d ' iceulz
iceulz,commeditest,par.	iceulz , comme dit est , par .
nostreditfrere	nostre dit frere
frereetparses.hoirsmaslez	frere et par ses . hoirs maslez
maslez,descendansdesoncorpsendroiteligne,	maslez , descendans de son corps en droite ligne ,
heritablement,perpetuelmentetà	heritablement , perpetuelment et à
àtouzjours	à touz jours
jours,etdèsmaintenanticeulzchastel.	jours , et dès maintenant iceulz chastel .
.etchastelleriedeLodun,	. et chastellerie de Lodun ,
avectouteslesappartenancesetappendancesd'iceulz	avec toutes les appartenances et appendances d ' iceulz
iceulz,commeditest,avonseximé	iceulz , comme dit est , avons eximé
etosté,eximonsetostonsdudemainnede	et osté , eximons et ostons du demainne de
nostreroyaume,..sanzy	nostre royaume , . . sanz y
riensretenir,commentquecesoit	riens retenir , comment que ce soit
,pournousetnozsuccesseursroys	, pour nous et noz successeurs roys
deFrance..,exceptélehommage,la	de France . . , excepté le hommage , la
souverainetéet.le	souveraineté et . le
ressort,et	ressort , et
tousautresdroizroiaulz,	tous autres droiz roiaulz ,
pourveutoutesvoiezque,senostreditfreretrespassoitsanz	pourveu toutesvoiez que , se nostre dit frere trespassoit sanz
sanzhoirmasledesoncorps,outoutes	sanz hoir masle de son corps , ou toutes
foizqueleshoirs	foiz que les hoirs
maslesprocreezdeson..	masles procreez de son . .
corpsendroiteligne,se	corps en droite ligne , se
seaucunsenyavoit,trespassoientsanz	se aucuns en y avoit , trespassoient sanz
hoirsmaslesde	hoirs masles de
leurscorps	leurs corps
corpsendroiteligne,lesdischastelet	corps en droite ligne , les dis chastel et
chastellerieavectouteslesappartenancesetappendances,comme	chastellerie avec toutes les appartenances et appendances , comme
ditest,reviegnent..etretournentetsoient	dit est , reviegnent . . et retournent et soient
appliquezau	appliquez au
demainnede	demainne de
nostreroyaume;tout..ainsiqu'	nostre royaume ; tout . . ainsi qu '
'ilestoient	' il estoient
avantce	avant ce
presentdon	present don
ettransport.Si	et transport . Si
Sidonnons..enmandement	Si donnons . . en mandement
ànostrebailli	à nostre bailli
deTouraine,ou..à	de Touraine , ou . . à
sonlieutenant	son lieutenant
,quenostre	, que nostre
ditfrereousonlieutenant,oulescommis	dit frere ou son lieutenant , ou les commis
etdeputezdepar	et deputez de par
liouson	li ou son
ditlieutenant	dit lieutenant
lieutenant,il	lieutenant , il
metterealmentetdefaitenpossessionetsaisine	mette realment et de fait en possession et saisine
saisinecorporelledesdizchasteletchastellerie	saisine corporelle des diz chastel et chastellerie
,etlesappartenancesetappendancesd.'iceulz	, et les appartenances et appendances d . ' iceulz
,etlesenleisseet	, et les en leisse et
facejoirpaisiblement	face joir paisiblement
etsanzaucunempeschement,etànostrereceveurde	et sanz aucun empeschement , et à nostre receveur de
Tourainequelesdizchastelet	Touraine que les diz chastel et
etchastelleriesetlesappartenancesetappendancesd'	et chastelleries et les appartenances et appendances d '
iceulzostede	iceulz oste de
sesregistreset	ses registres et
comptes,sanz.	comptes , sanz .
enplusfairemention	en plus faire mention
eniceulz,etnostreditfreren'empesche	en iceulz , et nostre dit frere n ' empesche
enaucunemanieresèschosesdessusdites,maiz	en aucune manieres ès choses dessus dites , maiz
l'enlaisse	l ' en laisse
joirpaisiblement.Et	joir paisiblement . Et
pourcequecesoitferme..chose	pour ce que ce soit ferme . . chose
,etc.Sauf,etc.Cefutfait	, etc . Sauf , etc . Ce fut fait
etdonnéennostrechasteldu	et donné en nostre chastel du
duLouvrelezParis,le..iiiie	du Louvre lez Paris , le . . iiiie
jourdefevrierl	jour de fevrier l
'anlxvi,etde	' an lxvi , et de
nostreregneletiers...Parleroy	nostre regne le tiers . . . Par le roy
.Gontier.	. Gontier .
