Philippes,parlagracedeDieu,	Philippes , par la grace de Dieu ,
,roisdeFrance	, rois de France
,ànostre	, à nostre
améet.feelSimondeChastiauVillainHuguesLarchevesque	amé et . feel Simon de Chastiau Villain Hugues Larchevesque
,salutetamour.Comme	, salut et amour . Comme
nousvuillanzveillanzol'	nous vuillanz veillanz o l '
'aide..deDieu,àtout	' aide . . de Dieu , à tout
nostrepouair,..contrestier	nostre pouair , . . contrestier
ànosennemisdeFlandresetàleur	à nos enne mis de Flandres et à leur
desloiausemprinsesemprisesrefraindre,vous	desloiaus emprinses emprises refraindre , vous
vousaionspriéetrequisseursurl	vous aions prié et requis seur sur l
'amouret	' amour et
lafeautéquevousavezànouset	la feauté que vous avez à nous et
ànostreroiaume,etaveccede	à nostre roiaume , et avec ce de
toutenostreaucto	toute nostre aucto
ritévousaionsmandéquetantostvousapparellissiezappareillissiezpour	rité vous aions mandé que tantost vous apparellissiez appareillissiez pour
aler,..sanznuldelai,	aler , . . sanz nul delai ,
,verslespartiesdeFlandres	, vers les parties de Flandres
,leplushastivementetleplusbrief	, le plus hastivement et le plus brief
briefcheminquevouspourriez,etapparelliéconvenablement	brief chemin que vous pourriez , et apparellié conve nablement
nablement,seloncvostre	nablement , selonc vostre
pouair,	pouair ,
,degentdechevaletdepié,	, de gent de cheval et de pié ,
etvousdevousapparellierappareillieretpartir	et vous de vous apparellier appareillier et partir
nesoiezpassidiligentcommela	ne soiez pas si diligent comme la
besoignerequiert,sicommenousavonsentendu,	besoigne requiert , si comme nous avons entendu ,
encoresvous	encores vous
prionsnous	prions nous
etraqueronssiàcertescommepluspoons,sur	et raquerons si à certes comme plus poons , sur
l..'amouretlafeautéquevousavezà	l . . ' amour et la feauté que vous avez à
nousetànostreroiaume	nous et à nostre roiaume
,etaveccevous	, et avec ce vous
commandonssiestroitement	commandons si estroitement
commeplus	comme plus
poonsquevous,apparelliésisouffisamentcommepluspourrez	poons que vous , apparellié si souffisament comme plus pourrez
pourrez,voustraezsihastivementèsdites	pourrez , vous traez si hastivement ès dites
partiesdeFlandresquevous,sanznulledefaute,	parties de Flandres que vous , sanz nulle defaute ,
,soiezàArrazaujourdenostresemonse,et	, soiez à Arraz au jour de nostre semonse , et
sachiezquelebesoinsbesoingiesttiexquenous	sachiez que le besoins besoing i est tiex que nous
nousnedevrionstenirpourfeelne	nous ne devrions tenir pour feel ne
nepouramiquienceste	ne pour ami qui en ceste
neccessiténousfaudra.Donné	neccessité nous faudra . Donné
àParis,lev.	à Paris , le v .
jourd'aoust	jour d ' aoust
.Clausaest.	. Clausa est .
