Charles,etc...	Charles , etc . . .
Savoirfaisons,etc..	Savoir faisons , etc . .
.nousavoirreceu	. nous avoir receu
l’umblesupplicaciondesparenset	l ’ umble supplicacion des parens et
amyscharnelzdeYmbertMezeau,filsdeLucasMereau	amys charnelz de Ymbert Mezeau , fils de Lucas Mereau
(sic),hostellierdemourantàVouzailles,aagié	( sic ), hostellier demourant à Vouzailles , aagié
dexviii.ansou	de xviii . ans ou
ouenviron,contenantque	ou environ , contenant que
queleditYmbertMereau,LoysBareau,Pierre	que ledit Ymbert Mereau , Loys Bareau , Pierre
Pyneauetautres,.oumoisde	Pyneau et autres , . ou mois de
septembrederrenierpassé,alèrenttirerdel’arbaleste	septembre derrenier passé , alèrent tirer de l ’ arbaleste
au.lieudeBanançay,etaprès	au . lieu de Banançay , et après
cequ’ils	ce qu ’ ils
ilseurenttirédel’arbaleste,s’en	ils eurent tiré de l ’ arbaleste , s ’ en
retournèrentdeverslesoirenl	retournèrent devers le soir en l
’osteldu	’ ostel du
duprieurduditlieudeVouzailles	du prieur dudit lieu de Vouzailles
Vouzailles,pourcequ’il	Vouzailles , pour ce qu ’ il
yavoitvinàvendre,	y avoit vin à vendre ,
etdemandèrents	et demandèrent s
’ilyavoitquesoupper,etse	’ il y avoit que soupper , et se
assirentauboutdelatable,où	assirent au bout de la table , où
leprieurduditlieusouppoit,	le prieur dudit lieu souppoit ,
,etenleurcompaignieestoitJulienCharpentier	, et en leur compaignie estoit Julien Charpentier
Charpentier.Etlequelprieur	Charpentier . Et lequel prieur
prieurleurcommança	prieur leur commança
àdireque,s’	à dire que , s ’
’ilzeussentestéauditlieu	’ ilz eussent esté audit lieu
deVouzailles,illeureustfaitmettre[	de Vouzailles , il leur eust fait mettre [
enprison..]ungbasteleurqui	en prison . . ] ung basteleur qui
estoitvenuau	estoit venu au
audedansdelabarrièredeladicteforteresse,lequel	au dedans de la barrière de la dicte forteresse , lequel
faisoitagenoillierlesbonnesgensdevantluietleur	faisoit agenoillier les bonnes gens devant lui et leur
preschoitplusieursgabuserieset..museries	preschoit plusieurs gabuseries et . . museries
museries,et	museries , et
quepourluin’avoitvoulucesser	que pour lui n ’ avoit voulu cesser
,dontiln’estoitpascontent.Après	, dont il n ’ estoit pas content . Après
Aprèslesquellesparoles,ledit	Après lesquelles paroles , ledit
JulienCharpentiercommança	Julien Charpentier commança
àdireausdessusdiz	à dire aus dessus diz
qu’ilyavoitdesbasteleurs	qu ’ il y avoit des basteleurs
basteleurslogiezenl’ostelleriede	basteleurs logiez en l ’ ostellerie de
deLucasMereau,pèreduditYmbert	de Lucas Mereau , père dudit Ymbert
Ymbert,quiavoientungbouc	Ymbert , qui avoient ung bouc
boucetungcinge,	bouc et ung cinge ,
etqu’iltrouveroitbien	et qu ’ il trouveroit bien
bienmanièredelesavoir,oucasqu	bien manière de les avoir , ou cas qu
’ilplairoitaudit	’ il plairoit audit
Ymbert,etqu’ilzs’	Ymbert , et qu ’ ilz s ’
enesbatroient.AquoyleditYmbert	en esbatroient . A quoy ledit Ymbert
Mereaurespondi	Mereau respondi
respondiqu’ilenestoitbiencontent,	respondi qu ’ il en estoit bien content ,
maisqu’onnefist	mais qu ’ on ne fist
pointdenoise.EtalorsiceluiCharpentierdist..qu	point de noise . Et alors icelui Charpentier dist . . qu
’iln’yauroitaucune	’ il n ’ y auroit aucune
noiseetque	noise et que
,se..leditbasteleuretsesgenss’	, se . . ledit basteleur et ses gens s ’
’enapparcevoient,il	’ en apparcevoient , il
diroit.qu	diroit . qu
’ilaloitquerir	’ il aloit querir
sesferremensquiestoientouplanchierde	ses ferremens qui estoient ou planchier de
lamaisonethostellerieduditLucas,	la maison et hostellerie dudit Lucas ,
etqu’ils’envouloit	et qu ’ il s ’ en vouloit
alerhorsla	aler hors la
lamaison.Aprèslesquellesparolles	la maison . Après les quelles parolles
,lesdizBareau,Charpentier,Pineau	, les diz Bareau , Charpentier , Pineau
etYmbertMereausedepartirentduditprieuretserendirent	et Ymbert Mereau se departirent dudit prieur et se rendirent
devantlagrantportedela.dictehostellerie	devant la grant porte de la . dicte hostellerie
.Auquelhostel,leditYmbert,pour	. Auquel hostel , ledit Ymbert , pour
pourcequ’ilestoitfilz	pour ce qu ’ il estoit filz
deceans	de ceans
,voultets’efforça	, voult et s ’ efforça
deentrerpoursoy	de entrer pour soy
soyretraire,etenouvrantladicteportetrouva	soy retraire , et en ouvrant ladicte porte trouva
trouvaleditboucattachiéàunecharrète,	trouva ledit bouc attachié à une charrète ,
lequelfutprinsparleditBareauetautres,	lequel fut prins par le dit Bareau et autres ,
etleemmenèrentdevantlabarrièredupriorédudit	et le emmenèrent devant la barrière du prioré dudit
lieudeVouzailles,etilecleattachèrent.	lieu de Vouzailles , et ilec le attachèrent .
Etpource	Et pour ce
cequeleditboucfaisoitgrantbruit,leditYmbert	ce que le dit bouc faisoit grant bruit , ledit Ymbert
Mereau,quidemoura	Mereau , qui demoura
àlaporteduditprioré,aveclequelestoientles	à la porte dudit prioré , avec lequel estoient les
dizPineau,Perrin..Prahée,ditCholet	diz Pineau , Perrin . . Prahée , dit Cholet
,lefistramenerenlacourtde	, le fist ramener en la court de
dela..dictehostellerieoù	de la . . dicte hostellerie où
ilavoitestéprins,etasseztostaprès	il avoit esté prins , et assez tost après
après,iceluiPrahée,dit.Cholet,	après , icelui Prahée , dit . Cholet ,
retournapardeverslesdiz	retourna par devers les diz
YmbertetPineau,	Ymbert et Pineau ,
,quiestoientà.ladicte	, qui estoient à . la dicte
barrière,etleurdist	barrière , et leur dist
quelesdiz	que les diz
LoysBareau.etJulienCharpentier,quiestoientdemourez	Loys Bareau . et Julien Charpentier , qui estoient demourez
enladictemaisonpouravoirledit.cinge	en la dicte maison pour avoir le dit . cinge
cingeestoientdescouvers.Ettantost..aprèslesdiz	cinge estoient descouvers . Et tantost . . après les diz
PineauetYmbertMereauetleditPrahée,	Pineau et Ymbert Mereau et ledit Prahée ,
ditCholet,s’enretournèrent	dit Cholet , s ’ en retournèrent
etrevindrentverslamaisonde..	et revindrent vers la maison de . .
la.dictehostellerie,etsemisdrentenung	la . dicte hostellerie , et se misdrent en ung
cymetièrequiestdevantladictemaison,	cymetière qui est devant la dicte maison ,
eteulxestansouditcymetière,oyrentqueledit	et eulx estans oudit cymetière , oyrent que le dit
basteleuretses	basteleur et ses
gensfaisoientgrantnoiseàl’	gens faisoient grant noise à l ’
occasiondecequ	occasion de ce qu
’ilzavoient..oïz	’ ilz avoient . . oïz
les..dizBareauetCharpentier	les . . diz Bareau et Charpentier
oudithostel,et	oudit hostel , et
telementqueleditbasteleuryssi.hors	telement que ledit basteleur yssi . hors
deladicte	de la dicte
hostelleriepoursavoirquec’	hostellerie pour savoir que c ’
estoit.EtalorslesdizPineau,Cholet	estoit . Et alors les diz Pineau , Cholet
etautresd’..entr’eulxcommancèrentàgiecter	et autres d ’ . . entr ’ eulx commancèrent à giecter
despierresverslaporteoùestoitleditbasteleur,	des pierres vers la porte où estoit ledit basteleur ,
telementqu’ilseremistenladictehostellerieet	telement qu ’ il se remist en ladicte hostellerie et
etfermal	et ferma l
’uyssurluiet	’ uys sur lui et
etsesgens...	et ses gens . . .
.Etpourceque..derechieficeulx	. Et pour ce que . . de rechief iceulx
basteleuretsesgens,aprèsqu’ilz	basteleur et ses gens , après qu ’ ilz
eurentfermél’uys,commencèrentà..cryeret	eurent fermé l ’ uys , commencèrent à . . cryer et
àtancerplusqueparavent,nescet	à tancer plus que paravent , ne scet
leditYmbertàqui,etpourdoubteque	le dit Ymbert à qui , et pour doubte que
lui.etsesdizcompaignonsnefeissentvilennieauditLucas	lui . et ses diz compaignons ne feissent vilennie audit Lucas
Mereau,hostellier,sonpère	Mereau , hostellier , son père
père,ilfisttantqueladicte	père , il fist tant que ladicte
ladicteporteluifutouverte,etentra	ladicte porte lui fut ouverte , et entra
dedans,	dedans ,
,etcommançaàdireauditLoysBareauetCharpentierque	, et commança à dire audit Loys Bareau et Charpentier que
cen’estoitpasbienfaitdefaireceste	ce n ’ estoit pas bien fait de faire ceste
noise..,etleurdit:«Jevouspry	noise . . , et leur dit :« Je vous pry
,alez.vous	, alez . vous
vousen».Etadonclesdiz	vous en ». Et adonc les diz
Bareauet..	Bareau et . .
.Charpentier..yssirenthorsde	. Charpentier . . yssirent hors de
ladicte	la dicte
hostellerie,etdemouraenladictemaisonledit	hostellerie , et demoura en ladicte maison ledit
Ymbert.Aprèslesquelz	Ymbert . Après lesquelz
lesquelzBareauetCharpentier,Gilette,femmede	lesquelz Bareau et Charpentier , Gilette , femme de
OlivierGuillardet,basteleur,contrelavoulenté	Olivier Guillardet , basteleur , contre la voulenté
duditYmbert,yssihors	dudit Ymbert , yssi hors
hors,laquelleleditYmbert	hors , la quelle ledit Ymbert
Ymbertcuidadesonpovoirdesmouvoirqu	Ymbert cuida de son povoir desmouvoir qu
’ellene	’ elle ne
neyssisthorsladictehostellerie;mais	ne yssist hors la dicte hostellerie ; mais
cenonobstant	ce nonobstant
nonobstant,elleyssihorsen	nonobstant , elle yssi hors en
cryantàhaultevoix	cryant à haulte voix
etparplusieursfoiz:«Auxlarrons!auxlarrons	et par plusieurs foiz :« Aux larrons ! aux larrons
!»Contrelaquellefemme,ainsiqueondit,	!» Contre laquelle femme , ainsi que on dit ,
leditJulienCharpentierretourna,	ledit Julien Charpentier retourna ,
etpourlafairetaireouautrement,de	et pour la faire taire ou autrement , de
savoulenté,luidonnad	sa voulenté , lui donna d
’unbastonqu’ilavoit	’ un baston qu ’ il avoit
surlatesteouailleurs,..telementqu	sur la teste ou ailleurs , . . telement qu
’ellecheut	’ elle cheut
cheutautraversdel	cheut au travers de l
’usserie.Al’occasiondelaquellebateure	’ usserie . A l ’ occasion de laquelle bateure
etchosesdessusdictes,ladicteGilettequiestoit	et choses dessus dictes , ladicte Gilette qui estoit
grossed	grosse d
’enfant,commel’endisoit,cinq	’ enfant , comme l ’ en disoit , cinq
cinqousixjours.après	cinq ou six jours . après
aprèsouenviron,alade	après ou environ , ala de
vieàtrespassement.Pour	vie à trespassement . Pour
PourlequelcasleditYmbertMereau,	Pour lequel cas ledit Ymbert Mereau ,
,doubtantrigueurdejustice	, doubtant rigueur de justice
justices’estabsentédupaysetadelaisséses	justice s ’ est absenté du pays et a delaissé ses
pèreetmère..etautres	père et mère . . et autres
autressesparens	autres ses parens
parensetamys,etn’	parens et amys , et n ’
yoseroit.jamaisretourner	y oseroit . jamais retourner
retourner,senozgraceetmisericorde	retourner , se noz grace et misericorde
neluiestoientsurce	ne lui estoient sur ce
imparties,humblementrequerantque,	imparties , humblement requerant que ,
attenduqueledit.YmbertMereauestjeune	attendu que ledit . Ymbert Mereau est jeune
jeunefilzettoutson	jeune filz et tout son
tempss’	temps s ’
estportéet	est porté et
gouvernébien	gouverné bien
etdeuement,etestenfantdebon	et deuement , et est enfant de bon
fameetrenommée,	fame et renommée ,
etc.,et	etc ., et
que,s’ildonnaconseild’aler	que , s ’ il donna conseil d ’ aler
alerenlamaisonde	aler en la maison de
deson..ditpère	de son . . dit père
,cefutmoyennantcequ’ilz	, ce fut moyennant ce qu ’ ilz
ne..feroientpointdenoise	ne . . feroient point de noise
,etquequant	, et que quant
quantilfutentré	quant il fut entré
enladictemaisonildepartitlesdizbasteleur	en la dicte maison il departit les diz basteleur
basteleur,Bareau.etCharpentier,à	basteleur , Bareau . et Charpentier , à
àsonpovoir,	à son povoir ,
,afinqu’	, afin qu ’
’iln’yeust	’ il n ’ y eust
aucunenoise,etquelesdizcoupsqui	aucune noise , et que les diz coups qui
furentbaillezparleditCharpentier.ouBareauàla	furent baillez par ledit Charpentier . ou Bareau à la
dictefemmedudit.basteleurneluifurent	dicte femme dudit . basteleur ne lui furent
pas..baillezparlui,etn’	pas . . baillez par lui , et n ’
enfutcauseneconsentantdece	en fut cause ne consentant de ce
faire,aussin’estoit	faire , aussi n ’ estoit
ilpaspresentetenfuttrèsdesplaisant,	il pas present et en fut très desplaisant ,
etquedesjasatisfaciona	et que desja satisfacion a
estéfaicteauditmaryparcelluy	esté faicte audit mary par celluy
quifistlecoup,	qui fist le coup ,
ilnousplaise.	il nous plaise .
surceluipourveoiretimpartirnosdictesgraceet	sur ce lui pourveoir et impartir nos dictes grace et
et.misericorde.	et . misericorde .
Pourquoynous	Pour quoy nous
,etc.,auditYmbertMereauouditcasavonsquicté	, etc ., audit Ymbert Mereau oudit cas avons quicté
,remiset	, remis et
et.pardonné,	et . pardonné ,
etc.Sidonnonsenmandementauxbailli	etc . Si donnons en mandement aux bailli
deTouraine	de Touraine
etdes..ressors	et des . . ressors
etexempcionsd	et exempcions d
’AnjouetduMaine,seneschaldePoictouet	’ Anjou et du Maine , seneschal de Poictou et
etàtousnozautres	et à tous noz autres
justiciers,etc.	justiciers , etc .
DonnéàTours,	Donné à Tours ,
lexviejourde.decembre	le xvie jour de . decembre
decembrel’	decembre l ’
’andegracemilcccc.xlviii,.etde	’ an de grace mil cccc . xlviii , . et de
nostrerègnelexxviie.Ainsisigné:Par	nostre règne le xxviie . Ainsi signé : Par
Parleroy,àlarelacion	Par le roy , à la relacion
duconseil.G.de	du conseil . G . de
Bloys.—Visa.Contentor.E	Bloys .— Visa . Contentor . E
E.Froment.	E . Froment .
