Charles,parlagrace.deDieu	Charles , par la grace . de Dieu
roydeFrance.Savoirfaisonsà	roy de France . Savoir faisons à
àtous,presens	à tous , presens
presensetavenir,ànousavoiresté	presens et avenir , à nous avoir esté
humblementexposé	humblement exposé
delapartiedes	de la partie des
amischarnelzde.	amis charnelz de .
.JehanChaillot,	. Jehan Chaillot ,
,lejeune,povrejeunevarletdupaïs	, le jeune , povre jeune varlet du païs
dePoictou	de Poictou
Poictou,contenantquecomme,lepremierdimenchedekaresme	Poictou , contenant que comme , le premier dimenche de karesme
karesmederrenierpasséouenviron,leseigneurde	karesme derrenier passé ou environ , le seigneur de
Pauleon..eustmandé	Pauleon . . eust mandé
audit..exposant	au dit . . exposant
,quidemouroit	, qui demouroit
assezprèsdumanoird	assez près du manoir d
’icelluiseigneur,queilalastparleràlui	’ icellui seigneur , que il alast parler à lui
lui..,etpour	lui . . , et pour
pourcequeleditJehann’oseoit	pour ce que le dit Jehan n ’ oseoit
desobeirnereffuserd’aleraumandementd’	desobeir ne reffuser d ’ aler au mandement d ’
icelluiseigneur	icellui seigneur
,alapar	, ala par
deverslui,caril..	devers lui , car il . .
nesavoit..	ne savoit . .
queilluivouloit.Et.sitostqu	que il lui vouloit . Et . si tost qu
qu’ilfudeverslui,icelluiseigneurde	qu ’ il fu devers lui , icellui seigneur de
Pauleonluidistqu’ilconvenoitqu	Pauleon lui dist qu ’ il convenoit qu
qu’ilalastavecluien	qu ’ il alast avec lui en
certainlieu,oùilavoitàfaire.Et	certain lieu , où il avoit à faire . Et
Etaprèsce,environmienuit,icelluiseigneuretses	Et après ce , environ mienuit , icellui seigneur et ses
sesgenset	ses gens et
leditJehanenleurcompaigniealerent	le dit Jehan en leur compaignie alerent
alerentenun	alerent en un
hostel,ouquel.ilentrerentparforce,	hostel , ou quel . il entrerent par force ,
etenicellui	et en icellui
icelluitrouverentSymonne,femmedePierreMillot,	icellui trouverent Symonne , femme de Pierre Millot ,
,laquelefemmeleditseigneur..prinstparforceet	, la quele femme le dit seigneur . . prinst par force et
enfistsa..voulenté.Pourlequelcaset	en fist sa . . voulenté . Pour le quel cas et
etfaitdessusdit,le	et fait dessus dit , le
leditJehanquioncquesn’yfist	le dit Jehan qui oncques n ’ y fist
riens,forsseulementqueilfuen	riens , fors seulement que il fu en
lacompaignied’icelluiseigneuretsesdictesgens	la compaignie d ’ icellui seigneur et ses dictes gens
,auquelseigneuriln’osarefuserd’	, auquel seigneur il n ’ osa refuser d ’
’aleraveclui,comme	’ aler avec lui , comme
dit.est,etaussiilnesavoit	dit . est , et aussi il ne savoit
oùvouloitalerle	où vouloit aler le
ditseigneur	dit seigneur
,nequeilvouloitfaire,ettoutle	, ne que il vouloit faire , et tout le
tempsdesa	temps de sa
vieilaestédebonnevieethonneste	vie il a esté de bonne vie et honneste
conversacion,senzoncquesmaizavoirestéreprinzouattaint	conversacion , senz oncques maiz avoir esté reprinz ou attaint
attaintd’aucunautrevilaincasoumalefice,	attaint d ’ aucun autre vilain cas ou malefice ,
doubtantrigueurde	doubtant rigueur de
dejustice,.s’	de justice , . s ’
estabsentezdupaïs.Etpource	est absentez du païs . Et pour ce
aestéappellezànozdroiz,et	a esté appellez à noz droiz , et
doubtequeparcontumaceiln’	doubte que par contumace il n ’
aitestébannizdenostreroyaume	ait esté banniz de nostre royaume
,ou.quelpaïs	, ou . quel païs
iln’oseroitjamaizconversernerepairier	il n ’ oseroit jamaiz converser ne repairier
repairier,sesurcenelui	repairier , se sur ce ne lui
luiestoitnostregraceestendue,si	lui estoit nostre grace estendue , si
sicommeildit.Nous	si comme il dit . Nous
adcertes,eueconsideracionauxchosesdessusdictes	adcertes , eue consideracion aux choses dessus dictes
,voulansrigueurdejusticeencestepartie	, voulans rigueur de justice en ceste partie
estremoderéepar	estre moderée par
misericorde,	misericorde ,
auditJehan	au dit Jehan
Chaillot,oucasdessus	Chaillot , ou cas dessus
dit..,avonsquictié,remiset	dit . . , avons quictié , remis et
pardonné,	pardonné ,
et..parces	et . . par ces
presentesremettons,	presentes remettons ,
quictonsetpardonnons,denostregraceespecialet	quictons et pardonnons , de nostre grace especial et
etauctoritéroyal,le	et auctorité royal , le
lefaitetcas	le fait et cas
casdessusdiz,etledit	cas dessus diz , et le dit
ban,sepources’estensuy,	ban , se pour ce s ’ est ensuy ,
avectoutepeine,amendeetoffensecorporele,criminele	avec toute peine , amende et offense corporele , criminele
etcivile,queilpeutpourcausedes	et civile , que il peut pour cause des
chosesdessusdictesestreencouruzenversnousetjustice.	choses dessus dictes estre encouruz envers nous et justice .
Etlerestituonsàsa	Et le restituons à sa
bonnefameetrenommée,aupaïs	bonne fame et renommée , au païs
etàsesbiensnon	et à ses biens non
confisquez,enimposantsurcesilence.perpetuelànostre	confisquez , en imposant sur ce silence . perpetuel à nostre
procureur,presentet	procureur , present et
avenir,	avenir ,
satisfactionfaicteàpartiecivilement,..sefaicte	satisfaction faicte à partie civilement , . . se faicte
n’..est,premierement	n ’ . . est , premierement
etavanttouteeuvre,s’aucunestqui	et avant toute euvre , s ’ aucun est qui
enfacepoursuite.Sidonnonsenmandement,	en face poursuite . Si donnons en mandement ,
parcespresentes,auseneschalde	par ces presentes , au seneschal de
Xanctongeetàtous.noz	Xanctonge et à tous . noz
nozautresjusticiers,.presensetavenir	noz autres justiciers , . presens et avenir
avenir,ouàleurslieuxtenans,etàchascun	avenir , ou à leurs lieuxtenans , et à chascun
d’eulx,sicommeàlui.appartendra,	d ’ eulx , si comme à lui . appartendra ,
quedenostre	que de nostre
presentegraceet	presente grace et
remissionfacent,sueffrent..	remission facent , sueffrent . .
.etlaissentleditChaillotjoiretuserplainementet	. et laissent le dit Chaillot joir et user plainement et
paisiblement..,senzluidonnerousouffrirestre	paisiblement . . , senz lui donner ou souffrir estre
faitoudonnéempeschementaucunaucontraire;maiz..	fait ou donné empeschement aucun au contraire ; maiz . .
sesoncorpsouaucuns	se son corps ou aucuns
aucunsdesesbiensnon	aucuns de ses biens non
confisquezestoient	confisquez estoient
estoientpourceprinz,saisiz,levez	estoient pour ce prinz , saisiz , levez
ouarrestez	ou arrestez
arrestez,si.lesluimettez	arrestez , si . les lui mettez
oufaitesmettre,.tantostetsenzdelay,	ou faites mettre , . tantost et senz delay ,
àplainedelivrance.Etpourcequece	à plaine delivrance . Et pour ce que ce
soitchosefermeet..estableàtousjours,nous	soit chose ferme et . . estable à tousjours , nous
avonsfaitmettrenostreseel	avons fait mettre nostre seel
àcespresentes	à ces presentes
lettres..Saufnostre	lettres . . Sauf nostre
nostredroitenautreschoses	nostre droit en autres choses
etl’autruyentoutes.Donnéà	et l ’ autruy en toutes . Donné à
Paris,ou	Paris , ou
moisdefevrierl’an	mois de fevrier l ’ an
degrace	de grace
milccc.iiiixxethuit,etde	mil ccc . iiiixx et huit , et de
nostreregneleixe..Parleconseil	nostre regne le ixe . . Par le conseil
.N.deVoisines.	. N . de Voisines .
