Charles,etc.Savoirfaisons	Charles , etc . Savoir faisons
faisons,..etc.,que	faisons , . . etc ., que
commeJacquesleTailleursesoitrendunostrerebelleet	comme Jacques le Tailleur se soit rendu nostre rebelle et
etennemientenantleparti	et ennemi en tenant le parti
partideEdwartd'Angleterreetde	parti de Edwart d ' Angleterre et de
deEdwartdeGales	de Edwart de Gales
,sonfilzainsné,quiontcommenciéetfont	, son filz ainsné , qui ont commencié et font
guerreouvertecontrenousetnozsubgez,pour	guerre ouverte contre nous et noz subgez , pour
quoytouslesheritages	quoy tous les heritages
etbiensquelconquesd	et biens quelconques d
d'iceliJacquesassisenla	d ' iceli Jacques assis en la
duchiédeGuienne,enlavicontéde	duchié de Guienne , en la viconté de
deBrosseet	de Brosse et
ailleurs,quelquepartqu'ilsoientennostre	ailleurs , quelque part qu ' il soient en nostre
royaume,quifurentjadisauBorgnede	royaume , qui furent jadis au Borgne de
deSeris,noussontacquisetà	de Seris , nous sont acquis et à
nousappartiennent,comme.commisetconfisquéspourlaforfaiture	nous appartiennent , comme . commis et confisqués pour la forfaiture
forfaitured..'icelyJacques	forfaiture d . . ' icely Jacques
,lequel..est	, lequel . . est
demourantenGuienne	demourant en Guienne
avecnozdizennemis	avec noz diz ennemis
,.enleurdonnanttout	, . en leur donnant tout
leconfortetaidequ'ilpuetcontre	le confort et aide qu ' il puet contre
nousetnostre	nous et nostre
royaume,encommettantcrime	royaume , en commettant crime
delesemajesté.Et	de lese majesté . Et
puentbienvaloiriceulx	puent bien valoir iceulx
heritagesetbienscent	heritages et biens cent
livrestournoisdeterreou..rente	livres tournois de terre ou . . rente
renteparan,sicommel	rente par an , si comme l
l'endit.Nous,pourconsideraciondezbons	l ' en dit . Nous , pour consideracion dez bons
etaggreablesservicesqueJehanDuMesnil,escuier,	et aggreables services que Jehan Du Mesnil , escuier ,
,nousafaisle	, nous a fais le
letampspassé,faitencoreschascun	le tamps passé , fait encores chascun
chascunjourennozpresentesguerres,èsquellesil	chascun jour en noz presentes guerres , ès quelles il
ilaesté	il a esté
pris..prisonnierparpluseursfoiset	pris . . prisonnier par pluseurs fois et
derrainementenlabesoignede	derrainement en la besoigne de
Chandos,etmisàtrèsexcessiveraençon,montant	Chandos , et mis à très excessive raençon , montant
àsept.censfrans	à sept . cens frans
,etesperonsque	, et esperons que
queencoresnousface	que encores nous face
outempsavenir,	ou temps avenir ,
,àiceliJehanDu	, à iceli Jehan Du
Mesnilàtousjoursmais,pourli,	Mesnil à tous jours mais , pour li ,
seshoirs.etquidelui	ses hoirs . et qui de lui
aurontcause,avonsdonnéetoctroié,	auront cause , avons donné et octroié ,
donnonsetoctroions,parces	donnons et octroions , par ces
presentes,denostreauctoritéroyal,denostrecertaine	presentes , de nostre auctorité royal , de nostre certaine
certaine..scienceetgraceespecial,lesheritagesetbiensdu	certaine . . science et grace especial , les heritages et biens du
ditJacquesleTailleurdessusdiz,c'	dit Jacques le Tailleur dessus diz , c '
estassavoirprés,vignes,..	est assavoir prés , vignes , . .
.bois,terres	. bois , terres
,dismes,estans,censetrentes	, dismes , estans , cens et rentes
,terrages,avectousautres	, terrages , avec tous autres
drois,.proffis,	drois , . proffis ,
,emolumensetappartenancesquelconques,jusques	, emolumens et appartenances quelconques , jusques
àlavaluedezcentlivrestournoisdeterre	à la value dez cent livres tournois de terre
ourenteparandessusdictes,ànous	ou rente par an dessus dictes , à nous
advenuesetappartenans..,pourlacausedessusdicte,	advenues et appartenans . . , pour la cause dessus dicte ,
commeditest	comme dit est
est,àtenir..,possideretenlever	est , à tenir . . , possider et en lever
lezdrois,proffisetemolumens	lez drois , proffis et emolumens
parleditJehanDu	par le dit Jehan Du
Mesnil,seshoirsetquidelui	Mesnil , ses hoirs et qui de lui
arontcause,àtous	aront cause , à tous
tousjoursmais,commedesa	tous jours mais , comme de sa
proprechose.Sidonnonsen	propre chose . Si donnons en
enmandement,par	en mandement , par
parcespresentes	par ces presentes
presentes,.auseneschald'	presentes , . au seneschal d '
Anjouetdu.Maineet	Anjou et du . Maine et
àtousnosautresofficiers	à tous nos autres officiers
,presenset..avenir,ouà	, presens et . . avenir , ou à
leurslieuxtenansetàchascund	leurs lieuxtenans et à chascun d
'eulx,commeàluiappartendra,quedes	' eulx , comme à lui appartendra , que des
heritageset	heritages et
biensdessus	biens dessus
dessusdis,jusques	dessus dis , jusques
àlavalued'icelles	à la value d ' icelles
centlivresàtournois	cent livres à tournois
deterreourenteparan,	de terre ou rente par an ,
,ànousainsiadvenues	, à nous ainsi advenues
advenuesetappartenans,commeditest	advenues et appartenans , comme dit est
,mettent	, mettent
tantostetfacentmettre	tantost et facent mettre
,chascunendroitsoy	, chascun en droit soy
soy,leditJehanDuMesnilouson	soy , le dit Jehan Du Mesnil ou son
procureur.pourlui,enpossessionetsaisine,	procureur . pour lui , en possession et saisine ,
etd'..icellefacentetsueffrentli,	et d ' . . icelle facent et sueffrent li ,
seshoirsetquide	ses hoirs et qui de
liaurontcause,joir	li auront cause , joir
etuserpaisiblementetàtousjoursmès,	et user paisiblement et à tous jours mès ,
sanslimettrenesouffrirestremis	sans li mettre ne souffrir estre mis
misenceaucunempeschement,non.obstantquece	mis en ce aucun empeschement , non . obstant que ce
cedeustestreapliquiéetmis	ce deust estre apliquié et mis
ànostredemainneetordenancesquelconques..àcecontraires	à nostre demainne et ordenances quelconques . . à ce contraires
.Toutesvoiesn'est	. Toutesvoies n ' est
pasnostreententeque,sepouraucunecauseil	pas nostre entente que , se pour aucune cause il
advenoitque	advenoit que
nousrendissionsoufeissions	nous rendissions ou feissions
rendreyceulxheritagesetbiensau	rendre yceulx heritages et biens au
dit.Jacques	dit . Jacques
Jacques,nousfussionstenusd'enfaireaucunerecompensacion	Jacques , nous fussions tenus d ' en faire aucune recompensacion
recompensacionauditJehanDuMesnil,àseshoirsou	recompensacion au dit Jehan Du Mesnil , à ses hoirs ou
ouaianscausede	ou aians cause de
ly.Etque.cesoit	ly . Et que . ce soit
ferme,etc.	ferme , etc .
Sauf,etc.Donnéen	Sauf , etc . Donné en
nostrehostel	nostre hostel
deSaintPollèsParis,lexxejourde	de Saint Pol lès Paris , le xxe jour de
mars,l'an	mars , l ' an
degracemilccc.soixanteet	de grace mil ccc . soixante et
neuf,eldenostreregnelesisiesme.	neuf , el de nostre regne le sisiesme .
Parleroy	Par le roy
.J.deVernon..	. J . de Vernon . .
..—Visa.	. .— Visa .
