Charles.,etc.Savoir	Charles . , etc . Savoir
Savoirfaisonsà	Savoir faisons à
touz,presensetavenir,	touz , presens et avenir ,
nousavoirestéexposédelapartiedesamischarnelx	nous avoir esté exposé de la partie des amis charnelx
charnelxdeJehanBreteau,quecommedepuisdeux	charnelx de Jehan Breteau , que comme depuis deux
moisençaSymon	mois en ça Symon
delaGarde	de la Garde
GardeetJehanLainsné,duMarchais,ledit	Garde et Jehan Lainsné , du Marchais , le dit
Breteauestantenleurcompaignie	Breteau estant en leur compaignie
,eussentdeviséetaccordéensemblequeiljoueroientaus	, eussent devisé et accordé ensemble que il joueroient aus
billespourlevinl’un	billes pour le vin l ’ un
contrel’autre,etaucommancementdujeu	contre l ’ autre , et au commancement du jeu
,leditJehanLainsnédistaudit	, le dit Jehan Lainsné dist au dit
Symonqu’ilmeistgaigepourle	Symon qu ’ il meist gaige pour le
jeuetpourcequ’ilperdroit,..le	jeu et pour ce qu ’ il perdroit , . . le
lequelSymondistquenonferoit,etledit.	le quel Symon dist que non feroit , et le dit .
JehanLainsnédistetrespondique	Jehan Lainsné dist et respondi que
siferoit,etsurcemurentpluseursparoles,	si feroit , et sur ce murent pluseurs paroles ,
tantqueledit	tant que le dit
Symonappellale	Symon appella le
ditJehanLainsnévillain,lequelJehan	dit Jehan Lainsné villain , le quel Jehan
JehanLainsnédistqueiln	Jehan Lainsné dist que il n
’estoitpas	’ estoit pas
pasvillainetqu’ilestoitplusgentil	pas villain et qu ’ il estoit plus gentil
gentilhommequele..ditSymon;et	gentil homme que le . . dit Symon ; et
etlorsleditJehanBreteaudistà	et lors le dit Jehan Breteau dist à
ycelluiJehanqueilmentoitetleferyd’	ycellui Jehan que il mentoit et le fery d ’
unbaston	un baston
qu’iltrouvaensonchemin,	qu ’ il trouva en son chemin ,
parmila	parmi la
lajambe.,nonpasenentenciondelevouloirgriefment	la jambe . , non pas en entencion de le vouloir griefment
blecer,toutesvoiessanc	blecer , toutesvoies sanc
enyssyetdientaucuns	en yssy et dient aucuns
quelajambe	que la jambe
estoitbrisée.Ettantostdistledit..	estoit brisée . Et tantost dist le dit . .
BreteauauditJehanLainsnéqu	Breteau au dit Jehan Lainsné qu
qu’ilsefeistappareillier,etil	qu ’ il se feist appareillier , et il
paieroitvoulentierslesmiresetcoutastxxfrans...	paieroit voulentiers les mires et coutast xx frans . . .
Etcefait,vint	Et ce fait , vint
unmireou	un mire ou
cirurgienquiappareillaetliala	cirurgien qui appareilla et lia la
jambeduditJehanLainsné,maisassez	jambe du dit Jehan Lainsné , mais assez
tostaprèsycelluiLainsné	tost après ycellui Lainsné
lasefistdeslier...Etdepuisparfaute	la se fist deslier . . . Et depuis par faute
debongouvernementouautrement,parlavoulentéde	de bon gouvernement ou autrement , par la voulenté de
Dieu,vintenla	Dieu , vint en la
ladictejambeunemaladiequel’en	la dicte jambe une maladie que l ’ en
appellelemalSaintMessent,etd’	appelle le mal Saint Messent , et d ’
icellemaladieetferureleditJehanLainsnéjut	icelle maladie et ferure le dit Jehan Lainsné jut
jutaulit.maladeenvironxv	jut au lit . malade environ xv
.jours,	. jours ,
etpuisestalezdevieàtrespassement;	et puis est alez de vie à trespassement ;
etàsaderrenierefinpardonnaleditfaitau	et à sa derreniere fin pardonna le dit fait au
auditJehanBreteau.LequelJehanBreteau	au dit Jehan Breteau . Le quel Jehan Breteau
,doubtanzrigueurdejustice	, doubtanz rigueur de justice
,s’estabsentezdu..païs	, s ’ est absentez du . . païs
.Sinousonthumblementfait	. Si nous ont humblement fait
supplierlesdizexposans	supplier les diz exposans
exposansque,consideré	exposans que , consideré
consideréqueparavantleditfaitlesdizJehanBreteau	consideré que paravant le dit fait les diz Jehan Breteau
etJehanLainsné	et Jehan Lainsné
estoientbienamiset	estoient bien amis et
affinsensemble,etn’avoitonqueseule	affins ensemble , et n ’ avoit onques eu le
leditBreteauhayne,rancuneoumalivolenceau	le dit Breteau hayne , rancune ou malivolence au
ditLainsné,consideréaussiquepar	dit Lainsné , consideré aussi que par
longtempsleditJehanBreteaunousaservioufait	longtemps le dit Jehan Breteau nous a servi ou fait
denozguerres,et	de noz guerres , et
aencoresentenciondefaire,èsquellesil	a encores entencion de faire , ès quelles il
ilaestéprinsprisonnierpar	il a esté prins prisonnier par
deuxfoizetrançonnéàtrèsgrans	deux foiz et rançonné à très grans
rançons,dontil..aesté	rançons , dont il . . a esté
moultgrandementdommaigiez,etaussiqueilnefu	moult grandement dommaigiez , et aussi que il ne fu
onquesactainsneconvaincuzd’aucunautre	onques actains ne convaincuz d ’ aucun autre
crime,maisaesté	crime , mais a esté
hommedebonnevie	homme de bonne vie
,renomméeethonneste	, renommée et honneste
conversacion,noussurcevueillionseslargirnostregrace	conversacion , nous sur ce vueillions eslargir nostre grace
.Pourquoynous,ceschosesconsiderées,au	. Pour quoy nous , ces choses considerées , au
ditJehanBreteau,oucasdessuzdit,avons	dit Jehan Breteau , ou cas dessuz dit , avons
remis,quictiéetpardonné,remettons	remis , quictié et pardonné , remettons
,quictonsetpardonnons,denostre	, quictons et pardonnons , de nostre
nostregraceespecialetauctoritéroyal,tout	nostre grace especial et auctorité royal , tout
lefaitdessuzdit	le fait dessuz dit
,avectoute	, avec toute
peinneetamendecorporelle.,criminelleetcivile	peinne et amende corporelle . , criminelle et civile
,enquoyilpuetestreencouruenversnous	, en quoy il puet estre encouru envers nous
,pourcauseetoccasiondufait..dessuzdit	, pour cause et occasion du fait . . dessuz dit
,satisfaitàpartiecivilementtantseulement;enimposant	, satisfait à partie civilement tant seulement ; en imposant
imposantsurcesilenceperpetuelleànostre	imposant sur ce silence perpetuelle à nostre
nostreprocureur.Sidonnonsenmandementpar	nostre procureur . Si donnons en mandement par
parcespresentesànostrebaillidesressorset	par ces presentes à nostre bailli des ressors et
Exempcionsde.	Exempcions de .
Touraine,d’Anjou,duMainneetde	Touraine , d ’ Anjou , du Mainne et de
Poitou,et	Poitou , et
àtouzlesautresjusticiersdenostreroyaume,presens	à touz les autres justiciers de nostre royaume , presens
presensetavenir,età	presens et avenir , et à
leurslieuxtenans	leurs lieux tenans
tenans,quedenostrepresentegraceetremissionfacent,	tenans , que de nostre presente grace et remission facent ,
seuffrentetlessentleditJehanBreteaujoiretuser	seuffrent et lessent le dit Jehan Breteau joir et user
paisiblement,sanzlesempeschieraucontraire.	paisiblement , sanz les empeschier au contraire .
Etsesoncorps.	Et se son corps .
ouaucunsde	ou aucuns de
deses..biens	de ses . . biens
sontpource	sont pour ce
prins,saisizouarrestez,sileslui	prins , saisiz ou arrestez , si les lui
luimettentàplainnedelivrance.Etquecesoit	lui mettent à plainne delivrance . Et que ce soit
soitfermechoseetestableàtousjours,	soit ferme chose et estable à tousjours ,
nousavons	nous avons
faitmettrenostreseelàces	fait mettre nostre seel à ces
presentes.Saufenautreschosesnostredroit	presentes . Sauf en autres choses nostre droit
droitetl’autrui	droit et l ’ autrui
autruientoutes.DonnéàParis	autrui en toutes . Donné à Paris
,l’ande	, l ’ an de
grace..m.ccc.lxxxix,et	grace . . m . ccc . lxxxix , et
lexviedenostreregne,oumoisdejuing	le xvie de nostre regne , ou mois de juing
.Parleconseilestantà	. Par le conseil estant à
Paris.Lucas.—Forges.	Paris . Lucas .— Forges .
