Charles,etc.Savoirfaisonsàtouz,	Charles , etc . Savoir faisons à touz ,
presensetavenir.,quede	presens et avenir . , que de
delapartiedePierrePascaut,	de la partie de Pierre Pascaut ,
povreetsimplelaboureur	povre et simple laboureur
laboureur,nous.aestéexposéquecomme	laboureur , nous . a esté exposé que comme
comme,environQuaresmeprenant,àcertainjourderrenierement	comme , environ Quaresme prenant , à certain jour derrenierement
passéaprèssoupper,àheurede	passé après soupper , à heure de
soleilcouchant,leditexposantvoulsist	soleil couchant , le dit exposant voulsist
aleraufortde	aler au fort de
Beauvoir,oùilavoitacoustuméd	Beauvoir , où il avoit acoustumé d
’alerdenuytpourestreplus	’ aler de nuyt pour estre plus
plusseurement,etJehannesafemme	plus seurement , et Jehanne sa femme
tenistunpainappelléfouace,lequel	tenist un pain appellé fouace , lequel
ycelluiexposant	ycellui exposant
vouloitavoir.	vouloit avoir .
pouryporter,etledit	pour y porter , et le dit
exposantetsadicte	exposant et sa dicte
dictefemmeavecleurchamberierefeussentsuruneeschielle	dicte femme avec leur chamberiere feussent sur une eschielle
enleurhostel,parlaquellel’	en leur hostel , par laquelle l ’
endescentd’unplanchierdudit	en descent d ’ un planchier du dit
hostelaubas,	hostel au bas ,
etleditPierrevoulsist	et le dit Pierre voulsist
prendrela	prendre la
ladictefouacequetenoitsa	la dicte fouace que tenoit sa
dictefemme,laquelleparesbatement	dicte femme , laquelle par esbatement
ouautrementbaillaycellefouaceàleur	ou autrement bailla ycelle fouace à leur
chamberierequiestoitaudessusd’	chamberiere qui estoit au dessus d ’
’eulzsurl’eschiellemesmes,laquelle	’ eulz sur l ’ eschielle mesmes , laquelle
laquellechamberiere,	laquelle chamberiere ,
,quantelletintla	, quant elle tint la
dictefouace,.s’efforça	dicte fouace , . s ’ efforça
demonterplushault,afinquele	de monter plus hault , afin que le
leditexposantnela	le dit exposant ne la
laprist,lequelcontendoittousjours	la prist , lequel contendoit tousjours
monteraprès,quaril	monter après , quar il
ilestoitoumilieu,et	il estoit ou milieu , et
sadictefemmeletenoit	sa dicte femme le tenoit
parlarobe,afin	par la robe , afin
qu’ilnemontastplushault,etpour	qu ’ il ne montast plus hault , et pour
lereteniretempeschierqu’iln	le retenir et empeschier qu ’ il n
n’alastaprès	n ’ alast après
ladictechamberiere,etpourcequ’	la dicte chamberiere , et pour ce qu ’
ils’efforçoitdemonter	il s ’ efforçoit de monter
ladicteeschielleetd’	la dicte eschielle et d ’
icelle.chamberierepoursuivre,	icelle . chamberiere poursuivre ,
boutasadictefemmequiestoitaudessoubztellement	bouta sa dicte femme qui estoit au dessoubz tellement
tellementquesarobely	tellement que sa robe ly
ly..eschappa,	ly . . eschappa ,
,dontellecheyàterre.Duquel	, dont elle chey à terre . Duquel
faittantostaprèsmort	fait tantost après mort
s’enensuy.	s ’ en ensuy .
Etpourcequeleditexposant,doubtantrigueur	Et pour ce que le dit exposant , doubtant rigueur
rigueurdejusticeetd’estreprinsetemprisonnez	rigueur de justice et d ’ estre prins et emprisonnez
,etque.on	, et que . on
neprocedastcontreluirigoreusementparemprisonnement	ne procedast contre lui rigoreusement par emprisonnement
emprisonnement,arrestdesoncorpsouautrement,et	emprisonnement , arrest de son corps ou autrement , et
etqued.’	et que d . ’
icelluicasil	icellui cas il
ilnes’en.povoitjustifier,pour	il ne s ’ en . povoit justifier , pour
ce..quelorsoudithosteln’avoitfors	ce . . que lors ou dit hostel n ’ avoit fors
ly,sesdictefemme	ly , ses dicte femme
femmeetchamberiere,etaussitroublépour	femme et chamberiere , et aussi troublé pour
pour.ladouleur	pour . la douleur
delamortdesadictefemme,..s’	de la mort de sa dicte femme , . . s ’
enestalez.	en est alez .
.etabsentezdupaïsdepuis	. et absentez du païs depuis
depuisledittemps,etencores..enestabsenset	depuis ledit temps , et encores . . en est absens et
n’oseretourner,pourrigueur	n ’ ose retourner , pour rigueur
dejustice,separnousne	de justice , se par nous ne
luiestsurceimpartienostregrace,si	lui est sur ce impartie nostre grace , si
commeildit,ennoushumblement	comme il dit , en nous humblement
suppliantque.,considerél’ignoranceet	suppliant que . , consideré l ’ ignorance et
rudessedelui,etque	rudesse de lui , et que
oncquesmaisnefureprinsd’aucunmauvaizfait	oncques mais ne fu reprins d ’ aucun mauvaiz fait
,etquece	, et que ce
avintparcasd’aventureetnon	avint par cas d ’ aventure et non
mied’aguet..appensénedecertain	mie d ’ aguet . . appensé ne de certain
propos,ilnousplaisesurce	propos , il nous plaise sur ce
celuipourveoirdenostredictegrace.Pourquoynous	ce lui pourveoir de nostre dicte grace . Pour quoy nous
,attenduceque	, attendu ce que
ditest,auditsuppliant	dit est , au dit suppliant
,oucasdessusdit,	, ou cas dessus dit ,
,avonsquictié,pardonnéetremis,etparces	, avons quictié , pardonné et remis , et par ces
presentesquictons,pardonnonsetremettonsdegrace	presentes quictons , pardonnons et remettons de grace
grace..especialleditfait,les	grace . . especial le dit fait , les
lesappeaulxetban,seaucunss	les appeaulx et ban , se aucuns s
’ensontensuiz,	’ en sont ensuiz ,
,avectoutepeinnecorporele,criminele	, avec toute peinne corporele , criminele
etcivile,	et civile ,
,quepourcepuet	, que pour ce puet
avoir..encouruenvers	avoir . . encouru envers
enversnous,et..lerestituonsà	envers nous , et . . le restituons à
sabonnefame,renommée,au	sa bonne fame , renommée , au
aupaïsetàses	au païs et à ses
biensnon	biens non
confisquez,satisfacionfaicteàpartie	confisquez , satisfacion faicte à partie
partiepremierement,sefaicten’est.Sidonnons	partie premierement , se faicte n ’ est . Si donnons
enmandementparcespresentesauseneschaldeXantongeet	en mandement par ces presentes au seneschal de Xantonge et
etàtouznozautresjusticiers	et à touz noz autres justiciers
etofficiers,presenset	et officiers , presens et
avenir,ouàleurs	avenir , ou à leurs
lieuxtenansetà..chascund	lieuxtenans et à . . chascun d
d’eulz,si..	d ’ eulz , si . .
.commeàluiappartendra	. comme à lui appartendra
,queledit.suppliantfacentetlaissentjoir	, que le dit . suppliant facent et laissent joir
joiretuserpaisiblement.de	joir et user paisiblement . de
nostrepresente..	nostre presente . .
graceet.remission	grace et . remission
,etcontrela	, et contre la
lateneurd’icellene	la teneur d ’ icelle ne
lemolestent,facentouseuffrentestre	le molestent , facent ou seuffrent estre
molestéaucontraire..,encorpsne	molesté au contraire . . , en corps ne
enbiens,enaucune	en biens , en aucune
maniere,maissesbiens	maniere , mais ses biens
nonconfisquez,seaucunssontpourcepris	non confisquez , se aucuns sont pour ce pris
pris,detenuzouarrestez,lui	pris , detenuz ou arrestez , lui
mettentoufacentmettresansdelayàplaine	mettent ou facent mettre sans delay à plaine
delivrance.Etquecesoitfermechoseet	delivrance . Et que ce soit ferme chose et
estableàtousjours,nousavonsfait	estable à tousjours , nous avons fait
mettrenostreseelàcespresentes	mettre nostre seel à ces presentes
lettres.Saufenautrechosenostredroitet	lettres . Sauf en autre chose nostre droit et
etl’autruientoutes.Donnéà	et l ’ autrui en toutes . Donné à
àParis,oumoysdemay	à Paris , ou moys de may
l’andegrace	l ’ an de grace
milccc.iiiixxetcinq,et	mil ccc . iiiixx et cinq , et
denostre.regne	de nostre . regne
lequint.Par	le quint . Par
Parleroy,à	Par le roy , à
larelacionduconseil.J.de	la relacion du conseil . J . de
deCoiffy.	de Coiffy .
