Charles,etc.Savoirfaisons,etc.	Charles , etc . Savoir faisons , etc .
nousavoirreceul’umblesupplicacionde	nous avoir receu l ’ umble supplicacion de
deBartholomyBonnet,laboureur,filzde..feuGuillaumeBonnet	de Bartholomy Bonnet , laboureur , filz de . . feu Guillaume Bonnet
,demourantàVillennesenlaparroisse	, demourant à Villennes en la parroisse
d’AzayprèsnostrevilledeSaintMaixant	d ’ Azay près nostre ville de Saint Maixant
,contenantque,	, contenant que ,
encepresentmois..denovembre	en ce present mois . . de novembre
,ainsiqueleditsuppliantaloit	, ainsi que le dit suppliant aloit
aveclesbeufsetcharretede	avec les beufs et charrete de
sonditpereà..certainsboysappellez	son dit pere à . . certains boys appellez
lesboisdelaChaslonniere,pour	les bois de la Chaslonniere , pour
pourquerirdu	pour querir du
ditboispour	dit bois pour
eulxchaulfer,leditsuppliant,en	eulx chaulfer , le dit suppliant , en
alantauditbois,rencontraou	alant au dit bois , rencontra ou
grantcheminparlequell	grant chemin par lequel l
’envaenladictevilledeSaintMaixant	’ en va en la dicte ville de Saint Maixant
,deuxjeunesenfans,dontl’	, deux jeunes enfans , dont l ’
’ainsnén’avoitpointplusdexiiii	’ ainsné n ’ avoit point plus de xiiii
xiiii.ouxv.ans,l’	xiiii . ou xv . ans , l ’
undesquelzse	un desquelz se
sefaitappeller.	se fait appeller .
PierreBonnet,filzde	Pierre Bonnet , filz de
BartholomyBonnet,etl’autreGuillaume	Bartholomy Bonnet , et l ’ autre Guillaume
Bonnet,filzdeJehanBonnet	Bonnet , filz de Jehan Bonnet
,demourantàlaBrossed’Azay,	, demourant à la Brosse d ’ Azay ,
sescousinsgermains;	ses cousins germains ;
lesquelzvenoientdu	lesquelz venoient du
duditboysdelaChaslonniere,et..surquatrejumens	du dit boys de la Chaslonniere , et . . sur quatre jumens
jumensamenoyentduboispoureulx	jumens amenoyent du bois pour eulx
chauffer,avec	chauffer , avec
lesquelzenfansiltrouvafeuJehan..Cantinole,lequelaussi	lesquelz enfans il trouva feu Jehan . . Cantinole , lequel aussi
aussidemouroitenla.	aussi demouroit en la .
.dictevilledeSaint	. dicte ville de Saint
Maixent,	Maixent ,
etlequeldist	et lequel dist
ausdizenfansqu’ilzavoientprinsledit	aus diz enfans qu ’ ilz avoient prins le dit
boisquiestoit	bois qui estoit
surlesdictesjumensenung	sur les dictes jumens en ung
ungsienmarreaudeboysqu	ung sien marreau de boys qu
’ilavoit	’ il avoit
ouditboys.de[la]Chaslonniere,et	ou dit boys . de [ la ] Chaslonniere , et
appelloitlesdiz	appelloit les diz
enfanslarrons.Etnoncontent	enfans larrons . Et non content
dece,seprintàunedes	de ce , se print à une des
dictesjumens,laquelleappartenoitet	dictes jumens , la quelle appartenoit et
estoitauditperedu	estoit au dit pere du
duditsuppliant,etcouppalesanneaulxoù	du dit suppliant , et couppa les anneaulx où
oùsetenoientlescrochez	où se tenoient les crochez
crochez,èsquelzilzamenoientleboys	crochez , èsquelz ilz amenoient le boys
surladictejument,entelle	sur la dicte jument , en telle
tellemanierequ’ilfistcheoirladictejumentet	telle maniere qu ’ il fist cheoir la dicte jument et
leditboys	le dit boys
boysdontelleestoitchargéeenune	boys dont elle estoit chargée en une
unefangeestant	une fange estant
ou..ditchemin,etavecces’efforça	ou . . dit chemin , et avec ce s ’ efforça
etvoultcourirsusdefait	et voult courir sus de fait
ausdizenfans,	aus diz enfans ,
ouàl’und	ou à l ’ un d
’eulx.Lequelsuppliant,veantleditCantinole	’ eulx . Lequel suppliant , veant le dit Cantinole
Cantinoleesmeudemal	Cantinole esmeu de mal
malfaire,doubtantqu’ilcourust	mal faire , doubtant qu ’ il courust
sus,batist	sus , batist
ouinjuriastdeleurspersonnessesdizcousins	ou injuriast de leurs personnes ses diz cousins
,se..avança	, se . . avança
etalaversleditCantinole,auquel	et ala vers le dit Cantinole , au quel
ildistleplusgracieusementqu’ilpeut	il dist le plus gracieusement qu ’ il peut
peut..quec	peut . . que c
c.’estoit	c . ’ estoit
malfaitàluide	mal fait à lui de
vouloircourirsusainsiàses	vouloir courir sus ainsi à ses
sesdizcousinsetdeainsiavoircouppé	ses diz cousins et de ainsi avoir couppé
couppélesdizanneaulxet	couppé les diz anneaulx et
etfaitcequedessus	et fait ce que dessus
dessus..estdit.	dessus . . est dit .
LequelCantinolerespondibienoultrageusementauditsuppliant	Lequel Cantinole respondi bien oultrageusement audit suppliant
,enluidisantqu’ilnedemourroit	, en lui disant qu ’ il ne demourroit
point..pourlui	point . . pour lui
lui,etenregniantnostreCreateur	lui , et en regniant nostre Createur
Createurplusieursfoizle	Createur plusieurs foiz le
voultets’efforçafrapperd	voult et s ’ efforça frapper d
’unecognéequ’ilavoitentresesmains	’ une cognée qu ’ il avoit entre ses mains
,maisleditsuppliant	, mais le dit suppliant
,veantsonmauvaizetfelon	, veant son mauvaiz et felon
feloncouraige,printung	felon couraige , print ung
coutelde	coutel de
deuxpiezdelongqu	deux piez de long qu
’.ilavoit	’ . il avoit
àsoncoustéetletira	à son cousté et le tira
tirahorsdela	tira hors de la
lagueyne,etluidistques’ille	la gueyne , et lui dist que s ’ il le
frappoitdeladictecognée	frappoit de la dicte cognée
cognée,qu’ille	cognée , qu ’ il le
lefrapperoitduditcoutel.Maiscenonobstant,le	le frapperoit dudit coutel . Mais ce non obstant , le
leditsuppliant,doubtant	le dit suppliant , doubtant
queleditCantinolelefrappast,pour.	que le dit Cantinole le frappast , pour .
.cequ’il.	. ce qu ’ il .
nevouloitcesserets’efforçoitle	ne vouloit cesser et s ’ efforçoit le
lefrapperdeladictecognée,leditsuppliant,	le frapper de la dicte cognée , le dit suppliant ,
pourevaderauditCantinole,commançaàfouyr	pour evader audit Cantinole , commança à fouyr
fouyrenversladicte..	fouyr envers la dicte . .
charretequ’ilavoitamenéepouremporter	charrete qu ’ il avoit amenée pour emporter
duditboys,etenfuyant,ainsi	du dit boys , et en fuyant , ainsi
qu’ilfutprèsde	qu ’ il fut près de
ladictecharrete	la dicte charrete
,leditCantinole	, le dit Cantinole
luigectaladictecognéeaprès	lui gecta la dicte cognée après
sesjambes,delaquelleill	ses jambes , de laquelle il l
’eusttué,s’il	’ eust tué , s ’ il
l’eustactaint	l ’ eust actaint
,oul’eustmutilé	, ou l ’ eust mutilé
mutilé.Lequelsuppliant,veantla	mutilé . Le quel suppliant , veant la
laobstinacionduditCantinole,remistsonditcoutelen	la obstinacion du dit Cantinole , remist son dit coutel en
sadictegueyne,etprintungpaldela	sa dicte gueyne , et print ung pal de la
ladictecharrete,etdistauditCantinolequ’	la dicte charrete , et dist au dit Cantinole qu ’
ilcessastdeplusluicourirsus,mais	il cessast de plus lui courir sus , mais
leditCantinolen’envoultrien.	le dit Cantinole n ’ en voult rien .
faire,ainsperseveraen..sonmauvaizpropoz.Lesquelles	faire , ains persevera en . . son mauvaiz propoz . Lesquelles
chosesveansleditsuppliant	choses veans le dit suppliant
,etquele	, et que le
ditCantinolenevouloit	dit Cantinole ne vouloit
cesserde.tousjourslefrapper,enregniantfolementnostre	cesser de . tousjours le frapper , en regniant folement nostre
Createur,pourdoubtequ’	Createur , pour doubte qu ’
’illetuast.oumurtrist,considerantque	’ il le tuast . ou murtrist , considerant que
queautrementneluipovoitevader,sansentencionde	que autrement ne lui povoit evader , sans entencion de
levouloir	le vouloir
tuer,maisafin..	tuer , mais afin . .
qu’ilpeusteschapper	qu ’ il peust eschapper
d’ilecet.	d ’ ilec et .
escheversafureur,	eschever sa fureur ,
,frappaleditCantinoleung	, frappa le dit Cantinole ung
seulcoupsurlatesteduditpal;duquel	seul coup sur la teste du dit pal ; duquel
copleditCantinole	cop le dit Cantinole
,ceditjour,aladevieà	, ce dit jour , ala de vie à
àtrespassement.Pouroccasionduquelcas,ledit	à trespassement . Pour occasion duquel cas , le dit
ditsuppliantquiestjeuneshomsdel	dit suppliant qui est jeunes homs de l
l’aagedexxii.ouxxiii	l ’ aage de xxii . ou xxiii
..ansouenviron	. . ans ou environ
,mariéavecunejeunefemmede.	, marié avec une jeune femme de .
xviii.ans	xviii . ans
,quientousses	, qui en tous ses
autresfaiz,aestéde	autres faiz , a esté de
bonnefame	bonne fame
,renomméeethonnesteconversacion,	, renommée et honneste conversacion ,
sansoncquesmaisavoirestéreprins	sans oncques mais avoir esté reprins
,actaient	, actaient
ouconvaincud	ou convaincu d
’aucunvillaincas	’ aucun villain cas
,blasmeoureprouche	, blasme ou reprouche
,pourdoubtederigueurdejustice,	, pour doubte de rigueur de justice ,
,s’estabsentédupaysetn’	, s ’ est absenté du pays et n ’
yoseroitjamais	y oseroit jamais
retourner,senostregraceetmisericorde	retourner , se nostre grace et misericorde
neluiestoitsurceimpartie,humblementrequerant.	ne lui estoit sur ce impartie , humblement requerant .
que,attendu	que , attendu
queleditsuppliant,lequel	que le dit suppliant , le quel
,commeditest,aagiédexxii.ou	, comme dit est , aagié de xxii . ou
ouxxiii.ansouenviron,chargiéde	ou xxiii . ans ou environ , chargié de
jeunefemmede	jeune femme de
l’aagedexviii.	l ’ aage de xviii .
.ansouenviron,adelaisséesadictefemmesans	. ans ou environ , a delaissée sa dicte femme sans
aucungouvernement,queleditcasest.	aucun gouvernement , que le dit cas est .
.avenud’aventureetn’avoit	. avenu d ’ aventure et n ’ avoit
leditsuppliantparavantleditdebataucunemalveillance	le dit suppliant paravant le dit debat aucune malveillance
malveillanceounoiseavecledit	malveillance ou noise avec le dit
ditCantinole,	dit Cantinole ,
etfuticelluiCantinole	et fut icellui Cantinole
agresseuretinjurialescousinsduditsuppliant	agresseur et injuria les cousins du dit suppliant
suppliantetlesappellalarrons,ets’efforça	suppliant et les appella larrons , et s ’ efforça
efforçadeleurcourirsus,etc.,ilnous	efforça de leur courir sus , etc ., il nous
plaisesurce	plaise sur ce
luiimpartiricelles	lui impartir icelles
.Pour.quoy	. Pour . quoy
nous..,ceschosesconsiderées,voulansmisericordepreferer	nous . . , ces choses considerées , voulans misericorde preferer
àrigueurdejustice	à rigueur de justice
,auditsuppliantoucas	, au dit suppliant ou cas
dessusditavonsremys,quictéetpardonné,	dessusdit avons remys , quicté et pardonné ,
etc.Si.donnons	etc . Si . donnons
enmandementparcespresentesauseneschaldePoictou	en mandement par ces presentes au seneschal de Poictou
etàtousnozautresjusticiers.,etc.	et à tous noz autres justiciers . , etc .
DonnéàChinon,	Donné à Chinon ,
oumoisdenovembrel’andegrace	ou mois de novembre l ’ an de grace
milcccc.quarante..etcinq	mil cccc . quarante . . et cinq
,etdenostreregne	, et de nostre regne
lexxiiiie.	le xxiiiie .
.Ainsisigné:Parleroy	. Ainsi signé : Par le roy
,àlarelacionduconseil.	, à la relacion du conseil .
N.DuBrueil	N . Du Brueil
.—Visa.Contentor.E	.— Visa . Contentor . E
E.DuBan	E . Du Ban
