Loys,etc.Savoirfaisons	Loys , etc . Savoir faisons
àtous,presenset..avenir,	à tous , presens et . . avenir ,
nousavoirreceuel’.umble	nous avoir receue l ’ . umble
supplicaciondeJehanRegeault,jeunefilzdel	supplicacion de Jehan Regeault , jeune filz de l
’aagedeXXIIans..	’ aage de XXII ans . .
.ouenvironnaguèresproveuèsordres	. ou environ naguères proveu ès ordres
dediacre..,	de diacre . . ,
,contenantqueleditsuppliantdepuisdixansen	, contenant que ledit suppliant depuis dix ans en
ças’est	ça s ’ est
tousjourstenuetademouréenla	tousjours tenu et a demouré en la
villedeBressuyre	ville de Bressuyre
pourestudyeret..	pour estudyer et . .
.aprandresonservice,enesperanced’	. aprandre son service , en esperance d ’
estrehommed’	estre homme d ’
église.Durant	église . Durant
Durantlesqueletpuispeudetemps	Durant lesquel et puis peu de temps
ença,il	en ça , il
s’estacointéd	s ’ est acointé d
’unejeunefille	’ une jeune fille
nommée…,avecqueslaquelleils	nommée …, avecques laquelle il s
’estpar	’ est par
plusieursfoistrouvé..etfrequenté	plusieurs fois trouvé . . et frequenté
enl’osteldePhelippotdeBaillon	en l ’ ostel de Phelippot de Baillon
,demourantenladictevilledeBressuyre.	, demourant en ladicte ville de Bressuyre .
.Etpourceque,	. Et pour ce que ,
lequinziesmejourdecepresentmoisde	le quinziesme jour de ce present mois de
demars,leditsuppliantfutadvertyquefeu	de mars , ledit suppliant fut adverty que feu
AnthoineParroissien,varletcordouannier,le	Anthoine Parroissien , varlet cordouannier , le
menassoitdetuer,etqueluy	menassoit de tuer , et que luy
etaustrescompaignonsdeladictevilledeBressuyreavoiententreprins	et austres compaignons de ladicte ville de Bressuyre avoient entreprins
deriblerladictejeunefemme,icelluisuppliant	de ribler ladicte jeune femme , icellui suppliant
latransportaenunghosteldeladicte	la transporta en ung hostel de ladicte
ladictevilleouquel.demeureBrachain(sic)	ladicte ville ouquel . demeure Brachain ( sic )
Touay,poullaillerpourillecla..teniren	Touay , poullailler pour illec la . . tenir en
seureté.Etleditjour	seureté . Et ledit jour
,..environ	, . . environ
environl’euredeXIheuresdenuyt,ledit	environ l ’ eure de XI heures de nuyt , ledit
leditfeuParroissien	ledit feu Parroissien
etsescompaignons,armezetembastonnezd	et ses compaignons , armez et embastonnez d
’espéeset..	’ espées et . .
autres.bastonsinvasibles,setransportèrenten	autres . bastons invasibles , se transportèrent en
l’ostelduditAbrahan,ausquel	l ’ ostel dudit Abrahan , ausquel
ilzentrèrentparforceet	ilz entrèrent par force et
violence,faisant.	violence , faisant .
grantbruit.	grant bruit .
ettumulte,mesmementleditParroissien,lequel	et tumulte , mesmement ledit Parroissien , lequel
juroitetregnioitlenomdeDieu,	juroit et regnioit le nom de Dieu ,
nostrecreateur	nostre createur
,qu’iltueroitleditsuppliant;auquel	, qu ’ il tueroit ledit suppliant ; auquel
auquelbruitleditsuppliantquiestoitensachambreouvritl	auquel bruit ledit suppliant qui estoit en sa chambre ouvrit l
’uysd’icelle	’ uys d ’ icelle
quiestoit	qui estoit
pourveoirquelzgenss’estoient.Et	pour veoir quelz gens s ’ estoient . Et
sitostqu’ill’	si tost qu ’ il l ’
eustouverte,apperceutledit	eust ouverte , apperceut ledit
leditParroissienqui.montoitjàen	ledit Parroissien qui . montoit jà en
l’eschelleoudegrédelachambredudit	l ’ eschelle ou degré de la chambre dudit
duditsuppliant,aiantuneespéenueensamainet	dudit suppliant , aiant une espée nue en sa main et
unepierreenl’autre,pourvouloir..	une pierre en l ’ autre , pour vouloir . .
.batreetoultragerleditsuppliant.Et	. batre et oultrager ledit suppliant . Et
lorsledit	lors ledit
leditsuppliant,pour.évitersafureur,se	ledit suppliant , pour . éviter sa fureur , se
voultretirerensadictechambre.	voult retirer en sadicte chambre .
Etcevoyant,leditfeu..	Et ce voyant , ledit feu . .
Parroissientoutesmeuluideist:«Ha!ribault,	Parroissien tout esmeu lui deist :« Ha ! ribault ,
traistre,c’esttoyquejequiers,»	traistre , c ’ est toy que je quiers ,»
etendisantcesparolles,	et en disant ces parolles ,
gectacontreleditsuppliantladictepierrequ.’il	gecta contre ledit suppliant ladicte pierre qu . ’ il
tenoit,cuidantl’en	tenoit , cuidant l ’ en
frapperpar..	frapper par . .
lateste;pource..queledit	la teste ; pour ce . . que ledit
suppliantgauchistaucoup,ill’actaingnit	suppliant gauchist au coup , il l ’ actaingnit
actaingnitseullementparlecousté,duquel	actaingnit seullement par le cousté , duquel
coupille	coup il le
blessatrèsgriefvement.Etadoncleditsuppliant,considérant	blessa très griefvement . Et adonc ledit suppliant , considérant
considérantl’oultrage..àluifaitetles	considérant l ’ oultrage . . à lui fait et les
menassesduditParroissien,	menasses dudit Parroissien ,
etqu’il	et qu ’ il
s’efforçoit	s ’ efforçoit
monterensadictechambrepourobvier	monter en sa dicte chambre pour obvier
àsafureur	à sa fureur
fureur,printladicte	fureur , print ladicte
ladictepierredontill’avoitfrappé	ladicte pierre dont il l ’ avoit frappé
ouautrequ..	ou autre qu . .
’iltrouvaprèsdelui	’ il trouva près de lui
etenrepulsant	et en repulsant
repulsantl’oultrageà	repulsant l ’ oultrage à
àluifait,	à lui fait ,
la..gectaàl’encontredudit	la . . gecta à l ’ encontre dudit
duditfeuParroissien,delaquelleparcas	dudit feu Parroissien , de laquelle par cas
d’avanture,il	d ’ avanture , il
l’..actaingnitparla	l ’ . . actaingnit par la
lateste,acauseduquelcoup	la teste , a cause duquel coup
coupiltombaàterre	coup il tomba à terre
,tellementqu’illaconvintemporterchexle	, tellement qu ’ il la convint emporter chex le
lebarbier,etcomme	le barbier , et comme
onl’abilloit,distqueledit	on l ’ abilloit , dist que ledit
leditsuppliantavoitfaitquesaigede	ledit suppliant avoit fait que saige de
l’..avoirfrappéde	l ’ . . avoir frappé de
deladictepierre,etques’ilnel	de ladicte pierre , et que s ’ il ne l
’eustfrappé,	’ eust frappé ,
ill’eusttué.	il l ’ eust tué .
Etdepuis..enperceveranten	Et depuis . . en perceverant en
sonmauvais	son mauvais
vouloir,estant	vouloir , estant
aulitmalade,retiraetditparplusieur	au lit malade , retira et dit par plusieur
plusieurfoizlesdictes	plusieur foiz lesdictes
parolleset,s’ilpouvoitguerir,	parolles et , s ’ il pouvoit guerir ,
,quejamais	, que jamais
leditsuppliantne	ledit suppliant ne
nemourroitqueparsesmains...Al	ne mourroit que par ses mains . . . A l
’occasionduquelcoup	’ occasion duquel coup
,parfaulte	, par faulte
debongouvernementouautrement,.leditfeuParroissien,	de bon gouvernement ou autrement , . ledit feu Parroissien ,
,troisjoursaprès,estalléde	, trois jours après , est allé de
vieàtrespas	vie à trespas
.Pourl’occasionduquelcas,	. Pour l ’ occasion duquel cas ,
leditsuppliant,doubtantrigueur,etc.Pourquoy	ledit suppliant , doubtant rigueur , etc . Pourquoy
nous,etc.,voulans,etc.,	nous , etc ., voulans , etc .,
auditsuppliantavonsquicté..,remisetpardonnélefait	audit suppliant avons quicté . . , remis et pardonné le fait
faitetcasdessusditsavecquestoute	fait et cas dessus dits avecques toute
peine,etc.,enmettantau	peine , etc ., en mettant au
neant,etc.;etl’..avons	neant , etc .; et l ’ . . avons
restitué,etc.,satisfacion,etc...Etsur	restitué , etc ., satisfacion , etc . . . Et sur
ceimposons,etc.Si	ce imposons , etc . Si
donnonsenmandement	donnons en mandement
,etc.,au	, etc ., au
senechaldePoictououàson	senechal de Poictou ou à son
lieuxtenantàTouars,et	lieuxtenant à Touars , et
etàtous,	et à tous ,
etc.Etafin,etc	etc . Et afin , etc
etc.Sauf,etc.DonnéàTours	etc . Sauf , etc . Donné à Tours
,au..mois	, au . . mois
demars,l’.	de mars , l ’ .
andegracemil	an de grace mil
cccc.quatrevings,et	cccc . quatre vings , et
denostreregnelevingtiesme.Ainsisigné	de nostre regne le vingtiesme . Ainsi signé
:Parleroy	: Par le roy
,àlarelacion	, à la relacion
duConseil.DeMoulins.—Visa.Contentor.	du Conseil . De Moulins .— Visa . Contentor .
