Loys,etc.Savoirfaisonsàtous	Loys , etc . Savoir faisons à tous
presensetavenir,quenous	presens et avenir , que nous
ayansregardet	ayans regard et
etconsideracionauxgrans,continuelz,agreableset	et consideracion aux grans , continuelz , agreables et
etrecommandablesservicesquenostrechieretbien	et recommandables services que nostre chier et bien
améescuierd’escuierieAbel	amé escuier d ’ escuierie Abel
deBrisay	de Brisay
,seigneurdeBeaumont,nous	, seigneur de Beaumont , nous
a.parcydevantfaiz	a . par cy devant faiz
dèssonjeuneaage,	dès son jeune aage ,
,faitetcontinuechacunjouronfaitdenozguerres	, fait et continue chacun jour on fait de noz guerres
guerres,alentourdenostrepersonneennozplusgrans	guerres , alentour de nostre personne en noz plus grans
etprincipaulxaffaireset..esperonsqueencoresface	et principaulx affaires et . . esperons que encores face
letemps.avenir	le temps . avenir
voulansiceulxaucunementrecongnoistreenversluietesleversesdictes	voulans iceulx aucunement recongnoistre envers lui et eslever sesdictes
terresenhonneurset	terres en honneurs et
preeminences,àicellui,pourcescauses	preeminences , à icellui , pour ces causes
etconsideracions.	et consideracions .
.etautresàcenousmouvans,	. et autres à ce nous mouvans ,
avons.octroyéetoctroyons,	avons . octroyé et octroyons ,
voulonsetnousplaist,de	voulons et nous plaist , de
graceespecial,	grace especial ,
plainepuissanceet	plaine puissance et
auctorité..royal,	auctorité . . royal ,
,parcespresentes,qu’	, par ces presentes , qu ’
’ilpuisseetluiloisefaireordonneretestabliraudit	’ il puisse et lui loise faire ordonner et establir audit
auditlieudeBeaumontetseigneurie.dudit	audit lieu de Beaumont et seigneurie . dudit
lieu,en	lieu , en
laquelledetouteanciennetéiladroit	laquelle de toute ancienneté il a droit
detoutejustice,haultemoienneetbasseet	de toute justice , haulte moienne et basse et
aussiysouloitavoirdroit	aussi y souloit avoir droit
droitdechastellenie	droit de chastellenie
,seelauxcontractzettabellionspourrecevoir	, seel aux contractz et tabellions pour recevoir
etpassertoutesmanièresdecontractz,obligacionsetautres	et passer toutes manières de contractz , obligacions et autres
lettres,pourenjoirperpetuellementpar	lettres , pour en joir perpetuellement par
parlui..et	par lui . . et
sessuccesseurs,seigneursduditlieu	ses successeurs , seigneurs dudit lieu
deBeaumont,ensemble,des	de Beaumont , ensemble , des
droizetprerogativesquiendeppendent,toutainsi	droiz et prerogatives qui en deppendent , tout ainsi
quelesautresseigneursaians	que les autres seigneurs aians
seelauxcontractzontaccoustuméjoyretuser	seel aux contractz ont accoustumé joyr et user
user;et	user ; et
etlequelseel	et lequel seel
ettabellionsnousavonscreez,ordonnezetestabliz	et tabellions nous avons creez , ordonnez et establiz
,creons,ordonnonsetestablissons	, creons , ordonnons et establissons
establissonsauditlieudeBeaumont.	establissons audit lieu de Beaumont .
.Etoultrelui	. Et oultre lui
luiavonsdonnéet	lui avons donné et
etoctroyé,donnonsetoctroyonsde..nostredictegracepar	et octroyé , donnons et octroyons de . . nostredicte grace par
parcesdictespresentes.,pourluietsessuccesseurs,	par cesdictes presentes . , pour lui et ses successeurs ,
seigneursdesdiz..lieux	seigneurs desdiz . . lieux
deBeaumontetdulieudeBram	de Beaumont et du lieu de Bram
,droitdeusaige	, droit de usaige
usaigeennostrefourest	usaige en nostre fourest
fourestdeMoulière,etvoulons	fourest de Moulière , et voulons
queluietses	que lui et ses
successeursseigneurs..desdizlieux,puisentperpetuelmentprandreen	successeurs seigneurs . . desdiz lieux , puisent perpetuelment prandre en
ladicteforest	ladicte forest
forest..toutle	forest . . tout le
boisqu’	bois qu ’
’illeursera	’ il leur sera
neccessairetantpourleurchauffagequepourbastir	neccessaire tant pour leur chauffage que pour bastir
bastir,construireetediffieresdizlieux,etduquel..	bastir , construire et ediffier esdiz lieux , et duquel . .
droitsespredecesseurs,seigneursdudit	droit ses predecesseurs , seigneurs dudit
lieudeBeaumont,ontjouyd’ancienneté	lieu de Beaumont , ont jouy d ’ ancienneté
,etlequeldroitd	, et lequel droit d
d’usage	d ’ usage
usageluietsessuccesseurstiendront	usage lui et ses successeurs tiendront
denousàfoyethommageà	de nous à foy et hommage à
àcausedenostrechasteldePoictiersetseront..tenuz	à cause de nostre chastel de Poictiers et seront . . tenuz
lefaireàchacunemuance	le faire à chacune muance
muance..deseigneuretvassal,	muance . . de seigneur et vassal ,
etaussi..	et aussi . .
àlarecepte	à la recepte
ordinaire.dePoictiers	ordinaire . de Poictiers
paier..ungesparvier	paier . . ung esparvier
,sansautrechargeoureddevance	, sans autre charge ou reddevance
reddevance..quelconque.Etpource	reddevance . . quelconque . Et pour ce
queauditlieude	que audit lieu de
deBeaumontfrequentent	de Beaumont frequentent
etaffluentchacunjourplusieursmarchans,par	et affluent chacun jour plusieurs marchans , par
quoy,pour	quoy , pour
lebienetaugmentacionde	le bien et augmentacion de
ladicteseigneurieetdes	ladicte seigneurie et des
habitansd’environ,	habitans d ’ environ ,
seroitbesoing	seroit besoing
etnecessité	et necessité
establiraucunesfoiresetmarché;nous,	establir aucunes foires et marché ; nous ,
ceschosesconsiderées..,	ces choses considerées . . ,
desiransdeplusenplusaugmenterladicte	desirans de plus en plus augmenter ladicte
seigneuriedeBeaumont	seigneurie de Beaumont
enhonneursetprerogatives..	en honneurs et prerogatives . .
,avonsauditlieudeBeaumontcreées,	, avons audit lieu de Beaumont creées ,
ordonnéesetestablies,	ordonnées et establies ,
creons,ordonnonsetestablissons,	creons , ordonnons et establissons ,
,denostre	, de nostre
plus.amplegrace	plus . ample grace
etauctoritétroisfoiresl.’anetungmarché	et auctorité trois foires l . ’ an et ung marché
parchacunesepmaine,c’estassavoirlesdictesfoires	par chacune sepmaine , c ’ est assavoir lesdictes foires
l’unelejouretfeste	l ’ une le jour et feste
monsieursainctBlaisequiestle	monsieur sainct Blaise qui est le
iiiejourde	iiie jour de
fevrier.,lasecondelejouretfeste	fevrier . , la seconde le jour et feste
monsieursainctGeorges,quiestlexxiiiejourde	monsieur sainct Georges , qui est le xxiiie jour de
deavril,etlatiercelejouret	de avril , et la tierce le jour et
festedu	feste du
glorieulxmartir	glorieulx martir
monsieursainctLaurens,	monsieur sainct Laurens ,
,quiestledixiesme..	, qui est le dixiesme . .
jourd’aoust	jour d ’ aoust
,etleditjourdemarchéunjourde	, et ledit jour de marché un jour de
mardiparchacunesepmaine;.et	mardi par chacune sepmaine ; . et
voulonsqueausdizjourslesdizfoiresetmarché	voulons que ausdiz jours lesdiz foires et marché
soientdoresnavantperpetuellementtenueset	soient doresnavant perpetuellement tenues et
quetous	que tous
marchansetautresquilesfrequenteront	marchans et autres qui les frequenteront
etàicellesaffluerontypuissentvendre,	et à icelles afflueront y puissent vendre ,
debiteret	debiter et
eschangertoutes	eschanger toutes
denrées.etmarchandiseslicitesethonnestesetqu’	denrées . et marchandises licites et honnestes et qu ’
ilzjoyssentdetelzetsemblablesprevilleiges,franchiseset	ilz joyssent de telz et semblables previlleiges , franchises et
etlibertezqu’ilzontacoustuméjoiretuser	et libertez qu ’ ilz ont acoustumé joir et user
userèsautresfoiresetmarchezduditpaïs.Et	user ès autres foires et marchez dudit païs . Et
pouricellestenir	pour icelles tenir
,voulonsetnousplaistqueleditAbelde	, voulons et nous plaist que ledit Abel de
Brizaypuissefaireconstruireeteddiffierhalles	Brizay puisse faire construire et eddiffier halles
entellieuoulieuxqu’.ilverra	en tel lieu ou lieux qu ’ . il verra
adceestrepropiceset	ad ce estre propices et
convenables.Sidonnonsen	convenables . Si donnons en
mandementà	mandement à
nozamezetfeaulxgensdenoz..comptesettresoriers	noz amez et feaulx gens de noz . . comptes et tresoriers
,auseneschal	, au seneschal
de..Poictou,	de . . Poictou ,
,maistreetreformateurgeneralde	, maistre et reformateur general de
nozEauesetforest,..etàtous	noz Eaues et forest , . . et à tous
tousnozautresjusticiersouàleurslieuxtenans,presenset	tous noz autres justiciers ou à leurs lieuxtenans , presens et
avenir,etàchacun	avenir , et à chacun
d’eulx,sicommeàluiappartiendraque	d ’ eulx , si comme à lui appartiendra que
denozpresensgraceetoctroy	de noz presens grace et octroy
ilzfacentetsouffrentleditAbeletsesdiz	ilz facent et souffrent ledit Abel et sesdiz
successeurs,seigneursdesdizlieux,	successeurs , seigneurs desdiz lieux ,
joiretuserpaisiblement	joir et user paisiblement
,.perpetuellementetàtousjours,sansleur	, . perpetuellement et à tousjours , sans leur
faireoumettre,nesouffrirestrefait	faire ou mettre , ne souffrir estre fait
oumisaucundestourbier	ou mis aucun destourbier
ouempeschement	ou empeschement
;aucontrairelequelse	; au contraire lequel se
faitoumis	fait ou mis
leurestoit,mettentoufacentmettreincontinant	leur estoit , mettent ou facent mettre incontinant
etsansdelay.	et sans delay .
àplainedelivranceetaupremierestatet	à plaine delivrance et au premier estat et
etdeu,enfaisant	et deu , en faisant
crieretpublierlesdictesfoiresetmarchéèslieux	crier et publier lesdictes foires et marché ès lieux
acoustumezetainsiqu’..ilestacoustuméfaire	acoustumez et ainsi qu ’ . . il est acoustumé faire
entelcas,etfaisantjoirlesmarchansqui	en tel cas , et faisant joir les marchans qui
lesfrequenterontdetelzet.semblables	les frequenteront de telz et . semblables
previlleges,franchisesetlibertezqu’ilzontacoustumé	previlleges , franchises et libertez qu ’ ilz ont acoustumé
acoustuméjoiretuserèsautresfoireset..marchezduditpaïs	acoustumé joir et user ès autres foires et . . marchez dudit païs
,pourveutoutesvoyesqueausdiz	, pourveu toutesvoyes que ausdiz
joursneàquatrelieues	jours ne à quatre lieues
lieuesàl	lieues à l
l’environn’yaitaucunesfoires	l ’ environ n ’ y ait aucunes foires
foiresetauditjourdemardiàdeux	foires et audit jour de mardi à deux
lieues..aucunmarché	lieues . . aucun marché
,àquilesdictesfoires	, à qui lesdictes foires
etmarchépuissentnuyre..ouprejudicier	et marché puissent nuyre . . ou prejudicier
.Etenrapportantcespresentes	. Et en rapportant ces presentes
presentessignées..denostremainouvidimusd’icellesfait	presentes signées . . de nostre main ou vidimus d ’ icelles fait
soubzseelroyaletrecongnoissancedenostredit	soubz seel royal et recongnoissance de nostredit
nostreditchambellansurcesuffisantepour	nostredit chambellan sur ce suffisante pour
unefoiztantseullement,nousvoulonstousnoz	une foiz tant seullement , nous voulons tous noz
receveursàquicepourratoucherenestreperpetuellementtenuz	receveurs à qui ce pourra toucher en estre perpetuellement tenuz
quictesetdeschargezparnosdizgensdescomptes,	quictes et deschargez par nosdiz gens des comptes ,
sansaucune.difficulté	sans aucune . difficulté
difficulté,nonobstant	difficulté , non obstant
quelzconquesordonnances,restrinctionsmandemensou	quelzconques ordonnances , restrinctions mandemens ou
deffencesà..	deffences à . .
.cecontraires.Etafin,etc.	. ce contraires . Et afin , etc .
.Sauf,etc.DonnéauPlesseysetduParc	. Sauf , etc . Donné au Plesseys et du Parc
lesTours,oumoisd’octobre	les Tours , ou mois d ’ octobre
l’andegracemil	l ’ an de grace mil
cccc.quatrevingsetdeux,	cccc . quatre vings et deux ,
etdenostrerègnelevingtetdeuxiesme.	et de nostre règne le vingt et deuxiesme .
.Ainsisigné:Loys.—..Parleroy.	. Ainsi signé : Loys .— . . Par le roy .
A.Robert.—	A . Robert .—
Visa.Contentor.	Visa . Contentor .
.Bernart.	. Bernart .
