Charles,etc.Savoirfaisons,etc	Charles , etc . Savoir faisons , etc
.nousavoirreceuel’umblesupplicacionde	. nous avoir receue l ’ umble supplicacion de
EstienneLamy,povrehomme,laboureur,demourant	Estienne Lamy , povre homme , laboureur , demourant
demourant..enl’isle	demourant . . en l ’ isle
isledeNermoustier	isle de Nermoustier
,.aagiéde	, . aagié de
xxii.ansouenviron,chargiédefemme	xxii . ans ou environ , chargié de femme
femmeetd’enfans,contenantqu’ils	femme et d ’ enfans , contenant qu ’ il s
’estentremisetapliquéletempspassé,et	’ est entremis et apliqué le temps passé , et
seyestbienethonnestementgouverné,	se y est bien et honnestement gouverné ,
àl’excerciceetmestier	à l ’ excercice et mestier
demarinieretàmeneret	de marinier et à mener et
conduireparmeretsur	conduire par mer et sur
eauemarchans,denrées	eaue marchans , denrées
etmarchandises,duquelmestier	et marchandises , duquel mestier
mestieretexcerciceilaacoustumévivreet	mestier et excercice il a acoustumé vivre et
avesquletemps	a vesqu le temps
tempspassé;	temps passé ;
;enlaquelleisledeNermoustiera	; en laquelle isle de Nermoustier a
ungbourgbeletnotable,lequelest	ung bourg bel et notable , lequel est
estdefferméetouvertsansaucune	est deffermé et ouvert sans aucune
closure,..etchampestre,ouqueldemeurentplusieurshabitans	closure , . . et champestre , ouquel demeurent plusieurs habitans
etouquela..plusieurs	et ouquel a . . plusieurs
plusieursruesetcheminspubliques	plusieurs rues et chemins publiques
publiques.Ouquelbourg	publiques . Ou quel bourg
deNermoustier,pourcequ’il	de Nermoustier , pour ce qu ’ il
estassissurport	est assis sur port
demer,affluentplusieurspersonnesd’estrangesnacions	de mer , affluent plusieurs personnes d ’ estranges nacions
,marchanset	, marchans et
autresdeceroyaumeendiversescontrées,lesquelzont	autres de ce royaume en diverses contrées , lesquelz ont
ontacoustumé,etaussiceulxdudit	ont acoustumé , et aussi ceulx dudit
bourget	bourg et
isle,prendreleursesbatemensetjouertantàla	isle , prendre leurs esbatemens et jouer tant à la
paulme,auxboulles	paulme , aux boulles
queàautres..	que à autres . .
.jeuzacoustumezà..joueren	. jeuz acoustumez à . . jouer en
ceroyaume..,etquelexvmejourdu	ce royaume . . , et que le xv me jour du
dumoisdefevrierderrenierementpasséleditsuppliantetautrescommancèrent	du mois de fevrier derrenierement passé ledit suppliant et autres commancèrent
àjoueràlaboulle	à jouer à la boulle
boulleparplusieursrueset	boulle par plusieurs rues et
etcheminsduditbourg.publiquement	et chemins dudit bourg . publiquement
publiquementetparplusieursfoiz,enalantetvenantpar	publiquement et par plusieurs foiz , en alant et venant par
lesdictesrues,eten	lesdictes rues , et en
especialen.unerueappelléelaruede	especial en . une rue appellée la rue de
deVauzeau,àlaveuedechascunquilevouloient	de Vauzeau , à la veue de chascun qui le vouloient
veoiretregarder,	veoir et regarder ,
,ainsique	, ainsi que
jeunesgensontacoustumédejouer,etque	jeunes gens ont acoustumé de jouer , et que
leditjourleditsuppliantetungautre	ledit jour ledit suppliant et ung autre
jouoientl’uncontrel’	jouoient l ’ un contre l ’
autreauditjeudesboulles,environheure	autre audit jeu des boulles , environ heure
devespres,enlacompaigniedeplusieurspersonnes	de vespres , en la compaignie de plusieurs personnes
quiacompagnoientleditsuppliantetceluiquijouoit	qui acompagnoient ledit suppliant et celui qui jouoit
jouoitcontrelui,etfirentleurjeuparladite	jouoit contre lui , et firent leur jeu par ladite
ruedeVauzeau,	rue de Vauzeau ,
,enlaquelleaplusieursmaisons,etydemeurentplusieurs	, en laquelle a plusieurs maisons , et y demeurent plusieurs
estagiers,etentrelesautresydemeureNicolasGazet	estagiers , et entre les autres y demeure Nicolas Gazet
Gazet,compèreduditsuppliant,	Gazet , compère dudit suppliant ,
,lequelasamaisonenladicterue;lequel	, lequel a sa maison en ladicte rue ; lequel
suppliantatenuetportésurles	suppliant a tenu et porté sur les
fonsunefilleduditGazet,del’aage	fons une fille dudit Gazet , de l ’ aage
aagedexii.àxiii.ans,	aage de xii . à xiii . ans ,
,nomméeKaterine;prèsde..	, nommée Katerine ; près de . .
laquellemaisondudit	laquelle maison dudit
Gazetaune	Gazet a une
placegasteappelléeayraut..,	place gaste appellée ayraut . . ,
,closededeuxboutzetd’un	, close de deux boutz et d ’ un
costédepetitmurdepierre,	costé de petit mur de pierre ,
et..del’autrecostéa	et . . de l ’ autre costé a
aunemaison.appartenantàEustacheBonamy	a une maison . appartenant à Eustache Bonamy
;.ouquelayrautou	; . ouquel ayraut ou
placeestoitladictefillenomméeKatherine..Gazete,fille	place estoit ladicte fille nommée Katherine . . Gazete , fille
filleduditNicolasGazetetfilleuledudit	fille dudit Nicolas Gazet et filleule dudit
duditsuppliant.Laquelleleditsuppliantneceulx	dudit suppliant . Laquelle ledit suppliant ne ceulx
ceulxquijouoientne	ceulx qui jouoient ne
lesautres..	les autres . .
.quiles	. qui les
lessuivoientetacompaignoientneveoientpointny	les suivoient et acompaignoient ne veoient point ny
nepovoientveoir,obstantce	ne povoient veoir , obstant ce
quelamaisonduditBonamyestoitentreledit	que la maison dudit Bonamy estoit entre le dit
suppliantetledit	suppliant et ledit
leditayrautou..place	ledit ayraut ou . . place
,enlaquelleestoit..ladictefille.Lequel	, en laquelle estoit . . la dicte fille . Lequel
suppliantauquelle.tourdejecterlaboulleavint	suppliant auquel le . tour de jecter la boulle avint
avint,estantenladicte..ruedeVauzeau	avint , estant en ladicte . . rue de Vauzeau
Vauzeau,printladicteboulle..pourgecter,et	Vauzeau , print ladicte boulle . . pour gecter , et
etpourcequ’il	et pour ce qu ’ il
nevistpersonnedumondedevant	ne vist personne du monde devant
devantsoy,àquiilpeustmalfaire	devant soy , à qui il peust mal faire
faire,gecta	faire , gecta
ladicteboulleenladicte	ladicte boulle en ladicte
ruedeVauzeau	rue de Vauzeau
Vauzeau,ettantostaprèsqu’ilotgecté	Vauzeau , et tantost après qu ’ il ot gecté
ladicteboulleetqu’ellefutpartie	ladicte boulle et qu ’ elle fut partie
desamain,incontinantaperceutladicte	de sa main , incontinant aperceut ladicte
KatherineGazete,safilleule,laquelleestoitoudit.	Katherine Gazete , sa filleule , laquelle estoit oudit .
ayraultouplace..	ayrault ou place . .
,..laquelle	, . . la quelle
estdeversladicterueouchemin	est devers ladicte rue ou chemin
publique,delaquelleboulleleditsuppliant	publique , de laquelle boulle ledit suppliant
ataignyladicteKatherineparlatesteetluirompyla	ataigny ladicte Katherine par la teste et lui rompy la
charetles	char et les
osdelateste	os de la teste
,tellementqueladicteKatherinetomba	, tellement que ladicte Katherine tomba
tombaàterretoutepasmée	tomba à terre toute pasmée
,combien	, combien
qu’ellen’eustriens	qu ’ elle n ’ eust riens
riensrompudelatayede	riens rompu de la taye de
delateste.Lequel.suppliant,incontinantqu’	de la teste . Lequel . suppliant , incontinant qu ’
ilvistladicteKatherine,safilleule.,	il vist ladicte Katherine , sa filleule . ,
alahastivementverselle,lalevaetprintentre	ala hastivement vers elle , la leva et print entre
entresesbrasetl’apportaen	entre ses bras et l ’ apporta en
l’ostel	l ’ ostel
duditGazet,père	dudit Gazet , père
pèredeladictefille,	père de ladicte fille ,
,etytrouvalamèredeladictefilleet	, et y trouva la mère de la dicte fille et
lamèredudit	la mère dudit
duditColasGazet,ayeulle.	dudit Colas Gazet , ayeulle .
deladicteKatherine;ausquellesfemmes	de ladicte Katherine ; ausquelles femmes
ildist,biendesplaisant	il dist , bien desplaisant
detoutsoncuer,qu’il	de tout son cuer , qu ’ il
avoitblecié	avoit blecié
leurfille,	leur fille ,
etquepourceil	et que pour ce il
feustmis	feust mis
remède.	remède .
Lequelsuppliant	Lequel suppliant
,desplaisantduditcas,mist	, desplaisant dudit cas , mist
grantpeineàestanchierle	grant peine à estanchier le
sangqueladictefillerendoit;aussifirent	sang que ladicte fille rendoit ; aussi firent
les..dictes	les . . dictes
femmes,etyfaisoitchascundumieulx	femmes , et y faisoit chascun du mieulx
mieulxqu’ilpovoit.Etasseztost	mieulx qu ’ il povoit . Et assez tost
aprèssepartistleditsuppliantduditlieu.Pour	après se partist ledit suppliant dudit lieu . Pour
lequelcas..,la	lequel cas . . , la
lajusticeduditlieuinventorialesbiensduditsuppliant	la justice dudit lieu inventoria les biens dudit suppliant
.Depuislequelcas,est	. Depuis lequel cas , est
estsurvenuàladicteKatherinecertainaccident	est survenu à ladicte Katherine certain accident
demaladie,telementqu’elleestdevenue	de maladie , telement qu ’ elle est devenue
percused’uncosté;	percuse d ’ un costé ;
àl’occasiondelaquelle	à l ’ occasion de laquelle
maladie,ladicteKatherinea	maladie , ladicte Katherine a
estéplusfortgrevéeetendommagéequepar	esté plus fort grevée et endommagée que par
parladicteplaye,commel’	par ladicte playe , comme l ’
endit.Etdepuis,c’est	en dit . Et depuis , c ’ est
estassavoir.xviii.joursaprèsouenviron,à	est assavoir . xviii . jours après ou environ , à
l’occasion	l ’ occasion
deladictemaladie,par.faultedegouvernement	de ladicte maladie , par . faulte de gouvernement
ouautrement,ladicteKatherineest	ou autrement , ladicte Katherine est
alléedevieàtrespassement,enbon	allée de vie à trespassement , en bon
bonsensetentendement,etapardonnéauditsuppliantet	bon sens et entendement , et a pardonné audit suppliant et
àtousautres.Al’	à tous autres . A l ’
occasionduquelcas,leditsuppliant	occasion duquel cas , ledit suppliant
suppliant,doubtantrigueur	suppliant , doubtant rigueur
dejustice,s’estabsentédupaïset	de justice , s ’ est absenté du païs et
etn’yoseroit	et n ’ y oseroit
jamais..retourner,	jamais . . retourner ,
senostregraceetmisericordeneluiestoit	se nostre grace et misericorde ne lui estoit
estoitsurceimpartie,humblementrequerantque,attenduce	estoit sur ce impartie , humblement requerant que , attendu ce
cequeditestetqueleditsuppliantn	ce que dit est et que ledit suppliant n
’.apasfait	’ . a pas fait
faitleditcasàsonesciant,	fait ledit cas à son esciant ,
maisestavenuparcasd’aventureet	mais est avenu par cas d ’ aventure et
defortune,dontila	de fortune , dont il a
aeuet..atrès	a eu et . . a très
grantdesplaisance	grant desplaisance
desplaisance,tantparce..queladiteKatherineestoitsafilleuleque	desplaisance , tant parce . . que ladite Katherine estoit sa filleule que
autrement,etc.Pourquoynous	autrement , etc . Pour quoy nous
,attenducequeditest	, attendu ce que dit est
,voulansmisericordepreferer	, voulans misericorde preferer
àrigueurdejustice,auditsuppliantavons.	à rigueur de justice , audit suppliant avons .
.oucasdessusditremis,	. ou cas dessus dit remis ,
quictiéetpardonné,etc	quictié et pardonné , etc
.Sidonnonsenmandement	. Si donnons en mandement
parcespresentesauxseneschaulxdePoictouetdeXanctonge	par ces presentes aux seneschaulx de Poictou et de Xanctonge
Xanctongeetgouverneur	Xanctonge et gouverneur
gouverneurdela.Rochelle,etàtousnoz	gouverneur de la . Rochelle , et à tous noz
autresjusticiers,etc.DonnéàTours,	autres justiciers , etc . Donné à Tours ,
oumoisdemarsl’	ou mois de mars l ’
andegracemilcccc.xlviii.avant	an de grace mil cccc . xlviii . avant
avantPasques,..etdenostrerègnelexxviie	avant Pasques , . . et de nostre règne le xxviie
.Ainsisigné	. Ainsi signé
:Parleroy	: Par le roy
,..àlarelacion	, . . à la relacion
relacionduconseil.Daniel.—	relacion du conseil . Daniel .—
Visa.Contentor.E.Froment.	Visa . Contentor . E . Froment .
