Charles,etc.,savoirfaisonsà	Charles , etc ., savoir faisons à
tous,presens.etavenir	tous , presens . et avenir
,nousavoirreceul’umble	, nous avoir receu l ’ umble
supplicaciondes	supplicacion des
desamischarnelzdeJehanDurant,povrelaboureur,chargé	des amis charnelz de Jehan Durant , povre laboureur , chargé
defemmeetenfans	de femme et enfans
,demourantouvillage..dela	, demourant ou village . . de la
Mignardere..enlaparroissedePeyrésur	Mignardere . . en la parroisse de Peyré sur
laRochesurIon,	la Roche sur Ion ,
contenantcomme,lejourdela	contenant comme , le jour de la
festesaintPierreenaoustderrenier	feste saint Pierre en aoust derrenier
passé,environheure	passé , environ heure
devespres,leditJehan	de vespres , le dit Jehan
Durantfeustpartide	Durant feust parti de
sonhostelduditlieudelaMignardiere,portant	son hostel du dit lieu de la Mignardiere , portant
portantunefourcheetunesarpe,	portant une fourche et une sarpe ,
enentenciond’alerclorreunesienne	en entencion d ’ aler clorre une sienne
terreseméeet	terre semée et
etemblavée,etenyalanttrouvaJehan.Nicoleauqui	et emblavée , et en y alant trouva Jehan . Nicoleau qui
ledepriaqueilluialasttueretappareillier	le depria que il lui alast tuer et appareillier
unmoutonen	un mouton en
ensonhosteldu	en son hostel du
Fié..,quiestoitassez	Fié . . , qui estoit assez
prèsduditlieu	près du dit lieu
delaMignardere.Etpourceyalale	de la Mignardere . Et pour ce y ala le
ditJehanDurant	dit Jehan Durant
etlefist,et	et le fist , et
etquantilotfait,	et quant il ot fait ,
,ils’enrevinten	, il s ’ en revint en
sondithostel	son dit hostel
hostelàlaMignardere,	hostel à la Mignardere ,
etillecquestrouvaunnomméGiletGendronneau	et illecques trouva un nommé Gilet Gendronneau
Gendronneau,laboureur,demourantàlamestairiedudit	Gendronneau , laboureur , demourant à la mestairie du dit
lieuduFié,	lieu du Fié ,
,quidisoit	, qui disoit
disoitque.certainesoesqui	disoit que . certaines oes qui
quiestoientaudit	qui estoient au dit
ditJehan.Durant	dit Jehan . Durant
Durantavoientestéensonorge	Durant avoient esté en son orge
etyavoientfaitdommage,	et y avoient fait dommage ,
etquepourceilles	et que pour ce il les
lesemmenroitenprisonenl’osteldu..ditJehan	les emmenroit en prison en l ’ ostel du . . dit Jehan
Nicoleau,..auditlieuduFié.	Nicoleau , . . au dit lieu du Fié .
Aquoyledit..Durantluirespondi	A quoy le dit . . Durant lui respondi
queycelles..oesn	que ycelles . . oes n
’avoientpointestéouditorge	’ avoient point esté ou dit orge
orgeneyfait	orge ne y fait
faitdommage,etsupposéque	fait dommage , et supposé que
queellesyeussentestéetfaitdommage,si	que elles y eussent esté et fait dommage , si
nedevoientellespasestremenées	ne devoient elles pas estre menées
enprisonauditlieuduFié,maisdevoient	en prison au dit lieu du Fié , mais devoient
encecasestremenéesauditlieudela	en ce cas estre menées au dit lieu de la
laMignardiere,dontestoitseigneurJametNicoleau	la Mignardiere , dont estoit seigneur Jamet Nicoleau
,veuqueledit	, veu que le dit
orgeestoit	orge estoit
estoitenlaseigneuriedu	estoit en la seigneurie du
duditJametNicoleau,	du dit Jamet Nicoleau ,
etnondu	et non du
duditlieuduFié,ouautres	du dit lieu du Fié , ou autres
parolessemblables,enempeschantauditGendronneau	paroles semblables , en empeschant au dit Gendronneau
queilneenmenastlesdites.	que il ne enmenast les dites .
.oesaudit	. oes au dit
lieuduFié.Età.cedebatseurvint	lieu du Fié . Et à . ce debat seurvint
seurvintAndréDurant,filz	seurvint André Durant , filz
filzduditJehan..Durant,et	filz du dit Jehan . . Durant , et
tantostqueyceluiGendronneaulevit,ils’	tantost que ycelui Gendronneau le vit , il s ’
adreçaà.	adreça à .
.lui,tenant	. lui , tenant
tenantenl	tenant en l
’unedesesmainsune	’ une de ses mains une
grossepierreeten	grosse pierre et en
l’autreungrant.baston	l ’ autre un grant . baston
bastonappelé.massue,enlui	baston appelé . massue , en lui
disant:«Ribaut,tu	disant :« Ribaut , tu
ymorras,tuasaujourd’	y morras , tu as au jour d ’
uycuidébatremes	uy cuidé batre mes
gens»,ouautres..parolessemblables,	gens », ou autres . . paroles semblables ,
etencedisant	et en ce disant
cuidafrapperledit..André	cuida frapper le dit . . André
deladictepierrequeiltenoitensamain	de la dicte pierre que il tenoit en sa main
main,etence	main , et en ce
ceconflitetpourempescher..leditcopet	ce conflit et pour empescher . . le dit cop et
etqueleditAndré	et que le dit André
n’enfeust	n ’ en feust
frappé,leditJehanDurant,	frappé , le dit Jehan Durant ,
sonpere	son pere
,meu.d’amour	, meu . d ’ amour
paternelleetpar	paternelle et par
chaudemeslée,frappa	chaude meslée , frappa
yceluiGendronneaududozd’unesarpeun	ycelui Gendronneau du doz d ’ une sarpe un
seulcopoufront,etatantsedeparti	seul cop ou front , et atant se departi
departileditGendronneau	departi le dit Gendronneau
ets’enalaen..	et s ’ en ala en . .
.sonhostel,etduditcop	. son hostel , et du dit cop
parmauvaisegardeouautrementestdepuis	par mauvaise garde ou autrement est depuis
alez..devieàtrespassement,troissepmainesouenviron	alez . . de vie à trespassement , trois sepmaines ou environ
environaprèsleditcasadvenu.Pouroccasionduquel	environ après ledit cas advenu . Pour occasion duquel
,yceluiJehanDurant,doubtantrigueurde	, ycelui Jehan Durant , doubtant rigueur de
justice,s’estabsentédupaïs,et	justice , s ’ est absenté du païs , et
puisaestécrié.àban	puis a esté crié . à ban
parjustice,etsesbiensmeublesinventoriésetmis	par justice , et ses biens meubles inventoriés et mis
enmaindejustice,sicomme	en main de justice , si comme
dientyceulxamischarnelz,ennous..humblementsuppliant	dient yceulx amis charnelz , en nous . . humblement suppliant
,commeentousautresfaisyceluiJehanDurant	, comme en tous autres fais ycelui Jehan Durant
Durantaitestéetsoitdebonnevie.et	Durant ait esté et soit de bonne vie . et
renommée,nonattaintne	renommée , non attaint ne
neconvaincud’aucunvilainblasmeoureprouche,	ne convaincu d ’ aucun vilain blasme ou reprouche ,
et.soitle	et . soit le
ditcas.advenu	dit cas . advenu
parchaudecoleetpartemptaciondel’	par chaude cole et par temptacion de l ’
ennemi,etpourpitié	ennemi , et pour pitié
pitiéetcompassiondesadictefemme	pitié et compassion de sa dicte femme
etenfans,quipouroccasiondeceseroient	et enfans , qui pour occasion de ce seroient
envoied	en voie d
’estredesers,	’ estre desers ,
nousluivueillionssurce	nous lui vueillions sur ce
impartirnostregraceet	impartir nostre grace et
misericorde.Pour	misericorde . Pour
quoynous	quoy nous
,voulanstousjoursmisericordepreferer	, voulans tousjours misericorde preferer
àrigueurde	à rigueur de
justice,auditJehan	justice , au dit Jehan
JehanDurantavonsouditcasremis,	Jehan Durant avons ou dit cas remis ,
quictéetpardonné,etc.Si.	quicté et pardonné , etc . Si .
donnonsenmandementaubaillideTouraineet	donnons en mandement au bailli de Touraine et
desressorsetExempcionsd’Anjou,dePoictou	des ressors et Exempcions d ’ Anjou , de Poictou
etdu..Maine	et du . . Maine
,augouverneurdelaRochelleetàtousnoz	, au gouverneur de la Rochelle et à tous noz
autresjusticiers.	autres justiciers .
,etc...DonnéàParis,	, etc . . . Donné à Paris ,
oumoisde	ou mois de
novembrel’	novembre l ’
’andegracemilcccc.etcinq,	’ an de grace mil cccc . et cinq ,
,etdenostreregnelexxvie.	, et de nostre regne le xxvie .
Parleroy,à	Par le roy , à
àlarelacionduconseil.Chaligaut.	à la relacion du conseil . Chaligaut .
