Philippes,etc.Savoir	Philippes , etc . Savoir
faisonsàtouz,presens	faisons à touz , presens
etavenir,nousavoir	et avenir , nous avoir
avoirveuleslettresouvertes	avoir veu les lettres ouvertes
,contenanzla	, contenanz la
lafourmequis	la fourme qui s
'ensuit:A	' ensuit : A
touzlesjusticiersduroyaumedeFrance,et	touz les justiciers du royaume de France , et
àtouzlesfeaulzet	à touz les feaulz et
subgiezdu	subgiez du
roynostreseigneur,	roy nostre seigneur ,
etàtouzautresausquelzcespresentes	et à touz autres aus quelz ces presentes
nozlettresvendront,GuillaumeChevrieretEstiennede	noz lettres vendront , Guillaume Chevrieret Estienne de
delaNoete,chanoinesdeTours,commissairesdenostre	de la Noete , chanoines de Tours , commissaires de nostre
ditseigneur,deputezoubailliagedeTouraine	dit seigneur , deputez ou bailliage de Touraine
surleschosescontenuesenceslettres,les	sur les choses contenues en ces lettres , les
lesquellesnousavonsreceues,contenansla	les quelles nous avons receues , contenans la
fourmequis'ensuit:Philippes	fourme qui s ' ensuit : Philippes
,parlagracedeDieu,	, par la grace de Dieu ,
roysdeFrance	roys de France
France.AnosamezmaistreGuillaumeChevrieret	France . A nos amez maistre Guillaume Chevrier et
Estiennedela	Estienne de la
laNoete,salut	la Noete , salut
etdilection...Commepour	et dilection . . . Comme pour
lesoppressionsetgriezqueplusieursdenostrepeupleont	les oppressions et griez que plusieurs de nostre peuple ont
lonctempssoustenuet	lonc temps soustenu et
soustenoientencores,parlesgransetexcessivesusures	soustenoient encores , par les grans et excessives usures
quelesdizlombarset	que les diz lombars et
lesYtaliensprestansà	les Ytaliens prestans à
usureprenoient.et	usure prenoient . et
etlevoientpar.leurfraudeuxcontraux,queilsfaisoient	et levoient par . leur fraudeux contraux , que ils faisoient
surnozsubgiez	sur noz subgiez
subgiezendiverse..partiedenostreroyaume,nousquide	subgiez en diverse . . partie de nostre royaume , nous qui de
deceavonsoy	de ce avons oy
plusieursclameurs,aienseu	plusieurs clameurs , aiens eu
grantcompassiondenozdizsubgiez,	grant compassion de noz diz subgiez ,
etparce	et par ce
ceaionsordené,pardeliberaciondenostregrant	ce aions ordené , par deliberacion de nostre grant
grantconseil,quedesusures	grant conseil , que des usures
qui.encores	qui . encores
sontàpaieraus	sont à paier aus
dizusuriers	diz usuriers
lesdebteurssoientquictesetdelivrés	les debteurs soient quictes et delivrés
delivrésplainementàtouzjours	delivrés plainement à touz jours
,enpaiantlepursorttantseulement,le	, en paiant le pur sort tant seulement , le
lequelpursortnous,pourcertainecauseet	le quel pur sort nous , pour certaine cause et
àplusbriefveetplusplainnedelivrance.	à plus briefve et plus plainne delivrance .
.desdebteurs,avonsordenéestremisen	. des debteurs , avons ordené estre mis en
ennostremain.,levéparycelleet	en nostre main . , levé par ycelle et
nonpaspar.	non pas par .
.lesmainsdesdiz	. les mains des diz
usuriers,	usuriers ,
,nous,pourmiexreleverencoresnozdiz	, nous , pour miex relever encores noz diz
subgiezdetravauxetdedespens,vousmandons..	subgiez de travaux et de despens , vous mandons . .
.etcommettonsque,.	. et commettons que , .
ceslettresveues,	ces lettres veues ,
,voustransportezpersonelmentèsvillesdubailliagede	, vous transportez personelment ès villes du bailliage de
Tours,oùvousverrezquebonsera.Et	Tours , où vous verrez que bon sera . Et
faitesassavoir,	faites assavoir ,
parcrisollempnel,nostredite	par cri sollempnel , nostre dite
ordenance,	ordenance ,
etquenullinepaie,nefine	et que nulline paie , ne fine
fine,necomposeavecaucundes	fine , ne compose avec aucun des
dizusurierscontre	diz usuriers contre
nostrediteordenance,etquetouz	nostre dite ordenance , et que touz
lesdizdebteurs.	les diz debteurs .
viegnentdeversvouspourreveleretdire.parleurs	viegnent devers vous pour reveler et dire . par leurs
leursseremens,parlesquelz	leurs seremens , par les quelz
nousvoulonsqueilsoientcreuz,selonqueà	nous voulons que il soient creuz , selon que à
vostrediscrecion	vostre discrecion
discrecionsemblera,consideréleurcondicion	discrecion semblera , consideré leur condicion
etl'instruction	et l ' instruction
àvousenchargée,toutesles.	à vous enchargée , toutes les .
debtesenquoychascund	debtes en quoy chascun d
d'eulzseratenuzausdizusuriersetàchascun	d ' eulz sera tenuz aus diz usuriers et à chascun
d'eulz,	d ' eulz ,
,tantenusurecomme.enpursort,eten	, tant en usure comme . en pur sort , et en
enpaiantlepursorttantseulementànostrereceveurde	en paiant le pur sort tant seulement à nostre receveur de
deTouraine,nousles	de Touraine , nous les
lesabsolonsetquittonsplainementà	les absolons et quittons plainement à
touzjoursdetoutes	touz jours de toutes
lesusuresetde	les usures et de
touzlesmandemens,despensetinterèsquis	touz les mandemens , despens et interès qui s
'enserontensuiz,..en	' en seront ensuiz , . . en
quelquemaniere.Etvoulonsquedeceleurdonnez	quelque maniere . Et voulons que de ce leur donnez
donnezvozlettresenbonnefourme,contenans	donnez voz lettres en bonne fourme , contenans
lateneurdecestes,les	la teneur de cestes , les
lesnomsdesdebteursetdesusuriers,et	les noms des debteurs et des usuriers , et
dessommessingulieres,adreçansàtouzlesjusticiersde	des sommes singulieres , adreçans à touz les justiciers de
nostreroyaume,lesquiexetà	nostre royaume , les quiex et à
chascund'eulznousvoulonsetcommandons	chascun d ' eulz nous voulons et commandons
commandons..estreobeissansà	commandons . . estre obeissans à
àvozditeslettres.	à voz dites lettres .
Ettoutcequiserapaiéduditpursort	Et tout ce qui sera paié du dit pur sort
faitesmettre.etretenirparmanierededepost	faites mettre . et retenir par maniere de depost
depostenlamaindudit..receveur,pour	depost en la main du dit . . receveur , pour
laporterouenvoier	la porter ou envoier
sanzdelay	sanz delay
,aumandementdenousoudenozgens	, au mandement de nous ou de noz gens
gens,deputezsurnozbesongnesà	gens , deputez sur noz besongnes à
Paris,prenantdeluison	Paris , prenant de lui son
serementqueiln	serement que il n
'enconvertiradenierailleursneautrement,forstant	' en convertira denier ailleurs ne autrement , fors tant
tantseulementtrentesoulzparisisparjourpourchascun	tant seulement trente soulz parisis par jour pour chascun
chascundevous,tantcomme	chascun de vous , tant comme
comme..vousserezenla	comme . . vous serez en la
laditebesongneèsditesparties,	la dite besongne ès dites parties ,
lesquiextrentesoulzpar	les quiex trente soulz par
journous	jour nous
nousvoulonsquechascunde.	nous voulons que chascun de .
.vousaitet..praignepar	. vous ait et . . praigne par
parlamainduditreceveur	par la main du dit receveur
,..etliendonnezvozlettresderecongnoissance	, . . et li en donnez voz lettres de recongnoissance
recongnoissancedecequevousenaurez..receu,parles	recongnoissance de ce que vous en aurez . . receu , par les
quellesrapportantet	quelles rapportant et
etlacopiedecespresentes,souzseelautentique	et la copie de ces presentes , souz seel autentique
,illiseraalloéenses	, il li sera alloé en ses
comptes.Etvoulonsetcommandonsque	comptes . Et voulons et commandons que
quetouznozjusticiersetsubgiezvous	que touz noz justiciers et subgiez vous
obeissentetentendentsurleschosesdessusdites	obeissent et entendent sur les choses dessus dites
ditesetsurtoutcequi	dites et sur tout ce qui
ypeut.appartenir.Donnéà	y peut . appartenir . Donné à
Paris,lexxviijejourdemarsl	Paris , le xxviije jour de mars l
l'andegracemilccc.quaranteetsix	l ' an de grace mil ccc . quarante et six
.—Parleconseil.Philippes,parlagrace	.— Par le conseil . Philippes , par la grace
deDieu,	de Dieu ,
roysdeFrance.A	roys de France . A
nozamezmaistreGuillaume	noz amez maistre Guillaume
ChevrieretEstiennedelaNoete,salut	Chevrier et Estienne de la Noete , salut
salut.Comme	salut . Comme
voussoiezcommis	vous soiez commis
etdeputezdeparnousèsseneschauciesde	et deputez de par nous ès seneschaucies de
dePoictou,d'AnjouetduMainne,et	de Poictou , d ' Anjou et du Mainne , et
oubailliagedeTouraine,etleursressors	ou bailliage de Touraine , et leurs ressors
ressors,suslefait	ressors , sus le fait
deslombarsusuriers,dequelque	des lombars usuriers , de quelque
quelquecondicionqueilsoient,	quelque condicion que il soient ,
,etnousaionsentenduqueaucuns	, et nous aions entendu que aucuns
fontimpetracions	font impetracions
denousdegraceset	de nous de graces et
deautreslettrespourvousempescheroufaitdevostre	de autres lettres pour vous empescher ou fait de vostre
commission,etl'ordenance	commission , et l ' ordenance
quenousavonsfaitesurce	que nous avons faite sur ce
ennostre..	en nostre . .
.grantconseil,laquelleordenancenousvoulonspar	. grant conseil , la quelle ordenance nous voulons par
vousestregardée	vous estre gardée
etacompliedepoint	et acomplie de point
pointenpoint,noncontrestanttouteimpetracion,faite	point en point , non contrestant toute impetracion , faite
faiteouàfaire,degracesoudeautreslettres..	faite ou à faire , de graces ou de autres lettres . .
.,parquelquepersonnequecesoit,nous	. , par quelque personne que ce soit , nous
vousmandonsetfermementenjoingnonsque	vous mandons et fermement enjoingnons que
bienetdiligement	bien et diligement
,tantostetsanzdelay,vousprocedez	, tantost et sanz delay , vous procedez
procedezetalez	procedez et alez
alezavantoufaitdevostre	alez avant ou fait de vostre
ditecommission,	dite commission ,
selonceque	selon ce que
quemandévousest,	que mandé vous est ,
etjouxte..la	et jouxte . . la
teneurdenostrediteordenance,noncontrestantquelconques	teneur de nostre dite ordenance , non contrestant quelconques
lettres,ougraces,ouautresde	lettres , ou graces , ou autres de
nousoudenostrecourtempetréesau	nous ou de nostre court empetrées au
contraire,surquelqueformede	contraire , sur quelque forme de
parollesquecesoit,.ausquelles	parolles que ce soit , . aus quelles
quellesnous..nevoulons,seellesvousviennent	quelles nous . . ne voulons , se elles vous viennent
viennent,quevousobeissiezenriens,sepremierement	viennent , que vous obeissiez en riens , se premierement
n'estoientpasséesetsignéesde	n ' estoient passées et signées de
denosamez	de nos amez
etfeaulzconseillers,lesabbésdeSaint-	et feaulz conseillers , les abbés de Saint -
Denis,deMermoustier	Denis , de Mermoustier
etdeCorbie,ouaucund	et de Corbie , ou aucun d
'eulz,maislesretenez	' eulz , mais les retenez
pardeversvouset	par devers vous et
les.nous	les . nous
nousapportezouenvoiez.Et	nous apportez ou envoiez . Et
estnostreententeque	est nostre entente que
leschoses..quevous	les choses . . que vous
ferezencestepartie	ferez en ceste partie
soientfermesetestablesàtouzjoursmais,et	soient fermes et estables à touz jours mais , et
etlesconfermeronstoutesfoizquerequisenserons.	et les confermerons toutes foiz que requis en serons .
DonnéàParis..	Donné à Paris . .
.,lequart	. , le quart
quartjourdemayl'	quart jour de may l '
'ande..gracemil	' an de . . grace mil
milccc.quaranteetsept.—	mil ccc . quarante et sept .—
Parleroy	Par le roy
roy,àlarelacionduconseil	roy , à la relacion du conseil
.Salut.etdilection.	. Salut . et dilection .
.Savoirfaisonsàvouset	. Savoir faisons à vous et
etàchascundevousque,par	et à chascun de vous que , par
parvertudesditeslettres,	par vertu des dites lettres ,
avonsfaitcrierparcris	avons fait crier par cris
sollempnelz..,à	sollempnelz . . , à
Toursetautresbonnesvillesdu	Tours et autres bonnes villes du
dudit.bailliage,	du dit . bailliage ,
l'ordenancedenostreditseigneurettoutesles	l ' ordenance de nostre dit seigneur et toutes les
autreschosescontenuesèslettresroyaux	autres choses contenues ès lettres royaux
royauxdessusdites.Et.partants'en	royaux dessus dites . Et . par tant s ' en
enestvenupardeversnous,à	en est venu par devers nous , à
Tours,lesamediaprèslasaintBarnabé,	Tours , le samedi après la saint Barnabé ,
apostre,PierredeMavau	apostre , Pierre de Mavau
Mavau,vallet,parroissiendeVendevre,duressort	Mavau , vallet , parroissien de Vendevre , du ressort
delaseneschaucied'Anjou,etnous	de la seneschaucie d ' Anjou , et nous
a..ditetrevelé	a . . dit et revelé
parsonserementcorporel,lequelnous	par son serement corporel , le quel nous
avonsreceusurce,	avons receu sur ce ,
,queilotetprist	, que il ot et prist
,àcausedeprest	, à cause de prest
etàusure,dePhilipponAndré	et à usure , de Philippon André
Andréetde	André et de
AndréVinteguerre,lombars,	André Vinteguerre , lombars ,
,lorsdemouransàPoitiers,quinzedeniers	, lors demourans à Poitiers , quinze deniers
d'orroyauxpourvint	d ' or royaux pour vint
vintlivresdemonnoiecourant,	vint livres de monnoie courant ,
environPasquesl.'	environ Pasques l . '
antrenteetneuf,et	an trente et neuf , et
que.lorspour	que . lors pour
pourcausedeceetdes	pour cause de ce et des
proffizet.	proffiz et .
usuresdutempsdepuis	usures du temps depuis
passé,ilconvintqueil	passé , il convint que il
seobligast,etseobligaausdiz	se obligast , et se obliga aus diz
dizlombarsen..quarantelivresdecellemesme	diz lombars en . . quarante livres de celle mesme
monnoie,etquedepuisilcompta	monnoie , et que depuis il compta
surce,etpourcausedeceet	sur ce , et pour cause de ce et
etdesproffizetusuresdu	et des proffiz et usures du
tempsdepuispassé..	temps depuis passé . .
,ilconvintqueil	, il convint que il
seobligast,etseobligaau	se obligast , et se obliga au
ditAndréensixvinslivresdemonnoie	dit André en six vins livres de monnoie
courantlors..pourletemps,etquedepuis	courant lors . . pour le temps , et que depuis
celeditAndrétournala	ce le dit André tourna la
debteàGautier.Vinteguerreet	debte à Gautier . Vinteguerre et
etàJaquesGuy,lombars	et à Jaques Guy , lombars
,etqueausdizGautier	, et que aus diz Gautier
GautieretJaques,pourcausede	Gautier et Jaques , pour cause de
ceetdes	ce et des
desproffizet	des proffiz et
usures,ilseobligaenonzevins	usures , il se obliga en onze vins
vinslivresdemonnoie	vins livres de monnoie
courantpourletemps,	courant pour le temps ,
c'estassavoirauditJaquesen	c ' est assavoir au dit Jaques en
vintlivres.etauditGautierentoutle	vint livres . et au dit Gautier en tout le
remenantdela	remenant de la
ditesomme,etquelorsil	dite somme , et que lors il
ilpaiaetbaillaauditAndrésurceuncheval	il paia et bailla au dit André sur ce un cheval
chevalenlavaluedequarante	cheval en la value de quarante
livresde.monnoie	livres de . monnoie
monnoielorscourant,etdepuisdixlivresàPhelippon	monnoie lors courant , et depuis dix livres à Phelippon
Andrédessusdit	André dessus dit
dit,etunepipedevin	dit , et une pipe de vin
vinquibienvaloitcent	vin qui bien valoit cent
cent.soulzdemonnoiecourantpourletemps	cent . soulz de monnoie courant pour le temps
temps,sanzen	temps , sanz en
fairenulrabatdeladitesomme	faire nul rabat de la dite somme
,etquedepuis..laditedebtefutournéeà	, et que depuis . . la dite debte fu tournée à
Baudinlelombart,etquedepuis,pour	Baudin le lombart , et que depuis , pour
pourcausede	pour cause de
deceetdesproffizetusures,parpluseurs	de ce et des proffiz et usures , par pluseurs
etdiverscomptesetcontraux	et divers comptes et contraux
contrauxusurairesetfraudeleus,..ilconvintque	contraux usuraires et fraudeleus , . . il convint que
queilse.obligast	que il se . obligast
obligastetseobligaau.	obligast et se obliga au .
ditBaudinVinteguerre,demourant	dit Baudin Vinteguerre , demourant
àLodun,en.cincq	à Lodun , en . cincq
censlivresbonne	cens livres bonne
fortmonnoie,c.'estassavoir	fort monnoie , c . ' est assavoir
assavoirpetiztournois.	assavoir petiz tournois .
,ouenflorins	, ou en florins
florinsd'oràl'	florins d ' or à l '
'escu,.chascun	' escu , . chascun
comptépour..seizesoulzethuitdeniers	compté pour . . seize soulz et huit deniers
enl'eslectiondudit	en l ' eslection du dit
Baudin;etquedepuisce	Baudin ; et que depuis ce
,pourcequeledit	, pour ce que le dit
Pierren'avoitdequoypaierla	Pierre n ' avoit de quoy paier la
laditesomme,enduità	la dite somme , enduit à
ceparlamaliceduditBaudin	ce par la malice du dit Baudin
,ilconvintqu	, il convint qu
qu'ilvendeist	qu ' il vendeist
vendeist,etvenditàmadameAgaite	vendeist , et vendit à madame Agaite
Agaite,damedeVarrieres,etàladame	Agaite , dame de Varrieres , et à la dame
deVerrez,lesquellesdamesnefurentonques	de Verrez , les quelles dames ne furent onques
presensà	presens à
ce,cinquantesextiersde	ce , cinquante sextiers de
defroment,	de froment ,
,àlamesurede	, à la mesure de
deLodun,ettrentelivresde	de Lodun , et trente livres de
petiztournoisderenteperpetuellerenduz..à	petiz tournois de rente perpetuelle renduz . . à
Lodun,..dedenslafestedeToussains,chascunan	Lodun , . . dedens la feste de Toussains , chascun an
,pourleprisdeladitesomme,et	, pour le pris de la dite somme , et
queledit.Baudin	que le dit . Baudin
Baudinparloitet	Baudin parloit et
pourchaçoitlaventedessus	pourchaçoit la vente dessus
dite,etqueladiterentefustassisesus	dite , et que la dite rente fust assise sus
suslemanoirdudit	sus le manoir du dit
Pierre,appelléMavau,et	Pierre , appellé Mavau , et
surlesappartenances.sises	sur les appartenances . sises
sisesenladiteparroisse,etsurtouzlesautres	sises en la dite parroisse , et sur touz les autres
autresbiensduditPierre;etque	autres biens du dit Pierre ; et que
leditPierrepromist	le dit Pierre promist
àfaireobliger	à faire obliger
obligeràceBeatrix,safame,	obliger à ce Beatrix , sa fame ,
,oulafairerenuncieràsondouaire,telcomme	, ou la faire renuncier à son douaire , tel comme
ellepovoitavoirsurleschoses	elle povoit avoir sur les choses
etbiens	et biens
duditPierre.	du dit Pierre .
,etque,àpoinnedecincqcenslivres	, et que , à poinne de cincq cens livres
,àfaireobligerladite	, à faire obliger la dite
Beatriz,ouà..renuncierà	Beatriz , ou à . . renuncier à
sondouairedessusditsusleschoseset	son douaire dessus dit sus les choses et
biensduditPierre,monsieurJehandeMontlyon,	biens du dit Pierre , monsieur Jehan de Montlyon ,
,chevalier,fustobligé.Et	, chevalier , fust obligé . Et
Et..cesteventefustfaiteetleslettrespassées	Et . . ceste vente fust faite et les lettres passées
passéessurce,environlaChandeleurquiful'	passées sur ce , environ la Chandeleur qui fu l '
anxlv.,	an xlv .,
etqueilconvintqueilconfesast	et que il convint que il confesast
,et..confessaèslettrespasséessur	, et . . confessa ès lettres passées sur
lesdizcontrauxet..comptes	les diz contraux et . . comptes
,quifurentetsontusuraireset	, qui furent et sont usuraires et
fraudeux,soyavoireu	fraudeux , soy avoir eu
etreceudesdizlombarset	et receu des diz lombars et
l'endevoir	l ' en devoir
toutesles	toutes les
sommesdessusditessuccessivement,àcausedebon	sommes dessus dites successivement , à cause de bon
etloyal.prest,	et loyal . prest ,
et..aussienfaisantladitevendicionetès	et . . aussi en faisant la dite vendicion et ès
diteslettrespasséessur	dites lettres passées sur
cesoyavoireu	ce soy avoir eu
euetreceudesdites	eu et receu des dites
ditesdamesleprisdecincqcenslivresbonnefort	dites dames le pris de cincq cens livres bonne fort
fortmonnoiedessusdites,jasoitcequeenverité	fort monnoie dessus dites , jasoit ce que en verité
iln'.ait	il n ' . ait
eunereceudesdizlombarsnemestantseulement	eu ne receu des diz lombars ne mes tant seulement
lessommesdepur	les sommes de pur
pursortdessusdites,etqueil	pur sort dessus dites , et que il
neeustonques	ne eust onques
rienssurcedesditesdames,ned	riens sur ce des dites dames , ne d
d'aucuned'icelles	d ' aucune d ' icelles
icelles;etquede	icelles ; et que de
denostrecommandementle	de nostre commandement le
ditdebteura	dit debteur a
abailléeet	a baillée et
etmis,parmanierededepost,enla	et mis , par maniere de depost , en la
lamaindureceveurde	la main du receveur de
deTourainne,ousonlieutenant,vintet	de Tourainne , ou son lieutenant , vint et
unelivrestournois	une livres tournois
enmonnoie	en monnoie
courantàpresent,pour	courant à present , pour
lavaluedequinze	la value de quinze
quinzeroyauxdepursortdessusdiz,ainsi	quinze royaux de pur sort dessus diz , ainsi
avaluezduditreceveur	avaluez du dit receveur
,ousonlieutenant,lasommede	, ou son lieutenant , la somme de
pursortdessus	pur sort dessus
dessusdit,	dessus dit ,
,àlafin.contenue	, à la fin . contenue
contenueèsditeslettres;etquepartantnousqui	contenue ès dites lettres ; et que partant nous qui
,consideréelacondicionduditdebteur	, considerée la condicion du dit debteur
quiesthommedebonestatet	qui est homme de bon estat et
etrenomméeetcondicion,seloncequeil	et renommée et condicion , selon ce que il
nousestapparu,ettantqueil	nous est apparu , et tant que il
n'estmievraysemblablequ'il	n ' est mie vraysemblable qu ' il
s'envousistparjurer,avonscreuet	s ' en vousist parjurer , avons creu et
creonsau	creons au
serementdudit	serement du dit
debteur,etdeAymeryGastine,delaparroisse	debteur , et de Aymery Gastine , de la parroisse
delaChapelleRoye,	de la Chapelle Roye ,
,..enPoitou,	, . . en Poitou ,
etdeJehan	et de Jehan
Boucin,delaparroissedeSaint-Simple	Boucin , de la parroisse de Saint - Simple
de.Tours,hommesde	de . Tours , hommes de
debonestatetbonne	de bon estat et bonne
condicion.,presenzàcedevantnousavec	condicion . , presenz à ce devant nous avec
avecleditPierre,	avec le dit Pierre ,
,èschosesdessus	, ès choses dessus
dites,quiparleursseremens	dites , qui par leurs seremens
,aprèsleserementduditPierre,.	, après le serement du dit Pierre , .
nousaffermerentqueil	nous affermerent que il
croientfermementqueleditPierrenous	croient fermement que le dit Pierre nous
avoitditverité,etfaitbon	avoit dit verité , et fait bon
bonserementès	bon serement ès
chosesdessusdites,surleschosesdessusdites.	choses dessus dites , sur les choses dessus dites .
(sic);avonsdeclaréetdeclaronsle	( sic ); avons declaré et declarons le
ditPierre	dit Pierre
,son..dit	, son . . dit
manoirdeMavauetlesappartenancesd	manoir de Mavau et les appartenances d
d'icelui,seshoirsetplaiges,etprincipaument	d ' icelui , ses hoirs et plaiges , et principaument
principaumentobligiezpourlui	principaument obligiez pour lui
ence,et	en ce , et
etaussileditmonsieurJehandeMontlion,leurs	et aussi le dit monsieur Jehan de Montlion , leurs
gaigesetautresbiens,estredeparnostre	gaiges et autres biens , estre de par nostre
ditseigneurabsolesetquictes,	dit seigneur absoles et quictes ,
par.lavertuetteneur	par . la vertu et teneur
desditeslettresroyaux,et	des dites lettres royaux , et
absolonset	absolons et
quictonsplainnement;par..lateneurde	quictons plainnement ; par . . la teneur de
decesnozpresenteslettres,parvertudesdites..	de ces noz presentes lettres , par vertu des dites . .
lettresroyaux..,	lettres royaux . . ,
desditessommes,tant	des dites sommes , tant
tantdepursort,commedeusures	tant de pur sort , comme de usures
usures,etdeladiterente,tantde	usures , et de la dite rente , tant de
blécommed'argent	blé comme d ' argent
,ainsivendueduditPierre	, ainsi vendue du dit Pierre
,etobligacionsetchargesd'icelles	, et obligacions et charges d ' icelles
,etdespromesseset	, et des promesses et
etpoinnesdessusdites,èsquellessommesetrente	et poinnes dessus dites , ès quelles sommes et rente
renteledit..	rente le dit . .
Pierreestoitobligiéaus	Pierre estoit obligié aus
dizlombars,ouaucund'eulz.,et	diz lombars , ou aucun d ' eulz . , et
etausditesdames,ouaucuned'icelles,	et aus dites dames , ou aucune d ' icelles ,
,commeditestdessus,etdetoutesautresusures	, comme dit est dessus , et de toutes autres usures
etdetouzamendemens,despensetinterès	et de touz amendemens , despens et interès
interès,etarreragesdeladiterente;	interès , et arrerages de la dite rente ;
queil,pourcauseet	que il , pour cause et
occasiondes	occasion des
deschosesdessusdites,pevent.oupourroient	des choses dessus dites , pevent . ou pourroient
estreensuizou	estre ensuiz ou
deuz..ausdizPheliponAndré	deuz . . aus diz Phelipon André
etAndré	et André
AndréVinteguerre,..etausditesdames,etchascun	André Vinteguerre , . . et aus dites dames , et chascun
d'eulz,	d ' eulz ,
etparconsequent	et par consequent
avonsdeclaréetdeclaronstoutesetchascuneles	avons declaré et declarons toutes et chascune les
lettresetcaucionsdesdizPhelippon,AndréetBaudin	lettres et caucions des diz Phelippon , André et Baudin
etdesditesdames,faitesetdonnéessurle	et des dites dames , faites et données sur le
pursortetusures,etrente,amendemens	pur sort et usures , et rente , amendemens
,despens	, despens
etinterès,arrerages,	et interès , arrerages ,
obligacions.,promesses	obligacions . , promesses
promessesetpoinnesdessusdizquelconques	promesses et poinnes dessus diz quelconques
,etdequelconqueformeou	, et de quelconque forme ou
oumanierequeilsoient,	ou maniere que il soient ,
contrele..ditPierre	contre le . . dit Pierre
etsesplaiges	et ses plaiges
,obligiezà	, obligiez à
cecommeprincipauxdebteurs,	ce comme principaux debteurs ,
leditmonsieurJehan,oucauseetoccasiondes	le dit monsieur Jehan , ou cause et occasion des
chosesdessus	choses dessus
dites,etleurshoirsetbiensestredetouz	dites , et leurs hoirs et biens estre de touz
touzpoinsnonvallablesetsanzeffect.Et	touz poins non vallables et sanz effect . Et
deffendons,de	deffendons , de
parnostreditseigneur,ausdizPhelippon,André	par nostre dit seigneur , aus diz Phelippon , André
etBaudinetausditesdames	et Baudin et aus dites dames
,etleursprocureurs,messagers,	, et leurs procureurs , messagers ,
alloezetporteursdesditeslettres	alloez et porteurs des dites lettres
lettresetcaucions,ettouzceux	lettres et caucions , et touz ceux
quiont.ou	qui ont . ou
ouauront,ouavoentou	ou auront , ou avoent ou
ouavouerontavoircausedesdizPhelippon,Baudinet	ou avoueront avoir cause des diz Phelippon , Baudin et
etAndré,etdesditesdames,ou	et André , et des dites dames , ou
d'aucund'eulz	d ' aucun d ' eulz
,parquelquemanierequecesoit,ès	, par quelque maniere que ce soit , ès
chosesdessusdites,ouaucune	choses dessus dites , ou aucune
aucuned'icelles.,sur	aucune d ' icelles . , sur
quanqueilsepeventmeffaireànostredit	quanque il se pevent meffaire à nostre dit
seigneurcivilement,queeulzouaucun	seigneur civilement , que eulz ou aucun
d'eulzneusentneexploictent,nefacent	d ' eulz ne usent ne exploictent , ne facent
userneexploictier	user ne exploictier
,pareulz	, par eulz
eulzouparautres,des	eulz ou par autres , des
desditeslettresoucaucions,	des dites lettres ou caucions ,
parvoiededemandedeexecucion,	par voie de demande de execucion ,
neautrement,nen'empeschentoufacentempeschier	ne autrement , ne n ' empeschent ou facent empeschier
leditPierre	le dit Pierre
,.seshoirs	, . ses hoirs
,sesplaiges.,ouprincipalmentà	, ses plaiges . , ou principalment à
àcepourli.obligiez	à ce pour li . obligiez
,etledit	, et le dit
monsieurJehan,	monsieur Jehan ,
,queilnese	, que il ne se
puissejoirplainementet	puisse joir plainement et
delivrementdesordenances	delivrement des ordenances
,quictanceetabsolucions	, quictance et absolucions
absolucionsdessusdites,etdecestesnozpresentes	absolucions dessus dites , et de cestes noz presentes
lettresetdeschosescontenuesenycelles,	lettres et des choses contenues en ycelles ,
enquelquemaniereoulieuxque	en quelque maniere ou lieux que
cesoient,neattemptentnenefacentattempter	ce soient , ne attemptent ne ne facent attempter
attempter,ouautrement,en	attempter , ou autrement , en
aucunemaniereque	aucune maniere que
cesoit,aucuneschosesencecontreles	ce soit , aucunes choses en ce contre les
dites.ordenances	dites . ordenances
,quictanceetabsolucion,oueffectd'icelles	, quictance et absolucion , ou effect d ' icelles
icelles,etlateneurdecespresentesnozlettres,	icelles , et la teneur de ces presentes noz lettres ,
etàtouzadvocasetconseilliersqueau	et à touz advocas et conseilliers que au
aucontrairedeschosesdessusdites,ouaucunesd'	au contraire des choses dessus dites , ou aucunes d '
icelles,nesoientenconseilouen	icelles , ne soient en conseil ou en
enaide,enquelquemaniere	en aide , en quelque maniere
oulieuquecesoit,contrele	ou lieu que ce soit , contre le
ditPierre	dit Pierre
ouseshoirs,plaigesou	ou ses hoirs , plaiges ou
ouprincipaulzobligiezà	ou principaulz obligiez à
àce,pour	à ce , pour
luiouleditmonsieurJehan.Et	lui ou le dit monsieur Jehan . Et
Etcomandonsestroictement,parnostreditseigneur,	Et comandons estroictement , par nostre dit seigneur ,
àtouz..etchascuns	à touz . . et chascuns
justiciers,feaulz.	justiciers , feaulz .
sergensetsubgiezdenostredit..	sergens et subgiez de nostre dit . .
seigneur,	seigneur ,
etsurquanque.ilse	et sur quanque . il se
sepeventmeffaireà	se pevent meffaire à
luicivilement,ettouzautresrequerons,	lui civilement , et touz autres requerons ,
deparluiet	de par lui et
nous,queilfacent	nous , que il facent
etlaissentleditPierre,	et laissent le dit Pierre ,
seshoirs,.	ses hoirs , .
plaiges,ouprincipalmentàceobligiez	plaiges , ou principalment à ce obligiez
obligiezpourluietleditmonsieurJehan,et	obligiez pour lui et le dit monsieur Jehan , et
ettouzleurs	et touz leurs
gaigesetbiens,	gaiges et biens ,
,joirplainementetfranchementdesdelivrance	, joir plainement et franchement des delivrance
,quictanceetabsolucion	, quictance et absolucion
dessusdites,entouzlieux,..sanzenfraindre,	dessus dites , en touz lieux , . . sanz enfraindre ,
,etqueilneviegnentnesouffrentveniraucontraire	, et que il ne viegnent ne souffrent venir au contraire
d'icelles	d ' icelles
,parquelquemaniereouenquelque..	, par quelque maniere ou en quelque . .
lieuquecesoitoupuisseestre,outemps	lieu que ce soit ou puisse estre , ou temps
avenir,etqueilfacentrendreetrestituer	avenir , et que il facent rendre et restituer
restituerauditPierreet	restituer au dit Pierre et
àsesplaiges,ouprincipalmentobligiezpourlui	à ses plaiges , ou principalment obligiez pour lui
,toutesetchascunesleslettresetcaucions,	, toutes et chascunes les lettres et caucions ,
ettouzleurs	et touz leurs
leursgaigesdessusdiz.,toutesfoiz	leurs gaiges dessus diz . , toutes foiz
etquantesfoizque	et quantes foiz que
ilenserontrequissouffisanmentduditPierre	il en seront requis souffisanment du dit Pierre
,oudesesplaiges,ou	, ou de ses plaiges , ou
ouprincipalmentobligiezpourlui...Etàcepourforcent	ou principalment obligiez pour lui . . . Et à ce pourforcent
,parprisedebiens	, par prise de biens
,.viguereusement	, . viguereusement
viguereusementetautrementdeuement	viguereusement et autrement deuement
,lesdiz	, les diz
Phelippon,BaudinetAndré..	Phelippon , Baudin et André . .
,etlesditesdames	, et les dites dames
,ettoutes	, et toutes
toutesautresquiontouaurontfacultez	toutes autres qui ont ou auront facultez
derendre	de rendre
rendreetrestituerleslettres,caucions,gageset	rendre et restituer les lettres , caucions , gages et
biensdessus	biens dessus
dessusdiz;ausquiex,ouchascund'eulz	dessus diz ; aus quiex , ou chascun d ' eulz
ausquiexcestesnozpresentes	aus quiex cestes noz presentes
presenteslettresserontmonstrées	presentes lettres seront monstrées
monstrées,nouscommettons,tantcommenouspoons,	monstrées , nous commettons , tant comme nous poons ,
cefairedeparnostreditseigneuretacomplir.	ce faire de par nostre dit seigneur et acomplir .
Entesmoingdesquelleschoses,nousavonsdonnéau..	En tesmoing des quelles choses , nous avons donné au . .
.ditPierrecestesnozpresenteslettres	. dit Pierre cestes noz presentes lettres
,seelléesdenozseaulz,avecleseel	, seellées de noz seaulz , avec le seel
seelduroy,duquell'en	seel du roy , du quel l ' en
useàTours.,lequelnous	use à Tours . , le quel nous
avonsfaitmettreetappouserenlapremiere	avons fait mettre et appouser en la premiere
queue..de	queue . . de
cespresentes.DonnéàTours,	ces presentes . Donné à Tours ,
lesamediaprèsla	le samedi après la
saintBernabé	saint Bernabé
,apostre,l'andegracemil	, apostre , l ' an de grace mil
ccc.quarante	ccc . quarante
etsept.Nousadecertestoutesleschosesdessusdites	et sept . Nous adecertes toutes les choses dessus dites
et..chascune	et . . chascune
chascuned'icelles,ainsicommeellessont	chascune d ' icelles , ainsi comme elles sont
plusàplaindeclaréeset	plus à plain declarées et
exprimées,ayansaggreables,fermesetestables,	exprimées , ayans aggreables , fermes et estables ,
icellesvolons,loons	icelles volons , loons
,aggreons,aprovons,	, aggreons , aprovons ,
,etdegraceespecialconfermons.Mandanz..etcommandans	, et de grace especial confermons . Mandanz . . et commandans
àtouznozjusticiers,ouàleurslieux	à touz noz justiciers , ou à leurs lieux
lieuxtenans,queles	lieux tenans , que les
dessusdizmariez.	dessus diz mariez .
etleursplaiges,ouautrementobligiez,ne	et leurs plaiges , ou autrement obligiez , ne
molestent,ne	molestent , ne
neseuffrentestremolesté,comment	ne seuffrent estre molesté , comment
quece.soit,contrela	que ce . soit , contre la
lateneurdecespresentes	la teneur de ces presentes
lettres,etleursbiens	lettres , et leurs biens
bienspourceprisousaisizleurfacenttantostrendreet	biens pour ce pris ou saisiz leur facent tantost rendre et
delivreràplain.Et	delivrer à plain . Et
quecesoitfermeet	que ce soit ferme et
etestableapperpetuité,nousavonsfaitmettre	et estable apperpetuité , nous avons fait mettre
nostreseel	nostre seel
nouvelàcespresenteslettres.Saufen	nouvel à ces presentes lettres . Sauf en
enautreschosesnostredroitetl'autruientoutes	en autres choses nostre droit et l ' autrui en toutes
.DonnéàParis,l'andegrace	. Donné à Paris , l ' an de grace
grace.milccc	grace . mil ccc
ccc.quaranteetsept,oumoisdejuing	ccc . quarante et sept , ou mois de juing
.Parleroy,	. Par le roy ,
àlarelacionduconseil.P	à la relacion du conseil . P
P...Briarre.Sinealiafinancia	P . . . Briarre . Sine alia financia
.Sy[mon.]	. Sy [ mon . ]
abb[as]M	abb [ as ] M
[ajoris]M[onasterii]Symonabbas..	[ ajoris ] M [ onasterii ] Symon abbas . .
