Charles,etc.Savoirfaisonsàtous,presens	Charles , etc . Savoir faisons à tous , presens
etavenir,nousavoiroyelasupplicacion	et avenir , nous avoir oye la supplicacion
deMichautMestraut,	de Michaut Mestraut ,
demourantenlavilledeCharchamp	demourant en la ville de Charchamp
CharchampprèsdePoictiers,enl'	Charchamp près de Poictiers , en l '
osteldeGuillaumeTaillant,contenantcommelui.	ostel de Guillaume Taillant , contenant comme lui .
.,JehanRaillartetJehandePoictiers..eussentdemouré	. , Jehan Raillart et Jehan de Poictiers . . eussent demouré
ensembleen	ensemble en
l'ostel	l ' ostel
duditGuillaume	du dit Guillaume
Guillaumeparl	Guillaume par l
l'espacedetroismoysouenviron,	l ' espace de trois moys ou environ ,
etpourcausedela	et pour cause de la
merveilletéetriotequiestoitenlapersonne	merveilleté et riote qui estoit en la personne
duditJehandePoictiers,.ledit	du dit Jehan de Poictiers , . le dit
Guillaumeluieust	Guillaume lui eust
donnécongié,etdepuis	donné congié , et depuis
depuisqu..'	depuis qu . . '
ileustcongié,ildistauditsuppliantque	il eust congié , il dist au dit suppliant que
ledit..Guillaume	le dit . . Guillaume
,sonmaistre,.disoit	, son maistre , . disoit
assezdemaldeluietluidonroitbienbrief	assez de mal de lui et lui donroit bien brief
congié,sicommeil.avoit	congié , si comme il . avoit
entendududitGuillaume,etla	entendu du dit Guillaume , et la
quellechoseainsidicte	quelle chose ainsi dicte
etraportéeauditsuppliant	et raportée au dit suppliant
suppliant,illeracontaauditGuillaume,sonmaistre	suppliant , il le raconta au dit Guillaume , son maistre
,ettantquelaveille	, et tant que la veille
delasaintLaurentderrenierementpassée.,leditGuillaume	de la saint Laurent derrenierement passée . , le dit Guillaume
mandaledit	manda le dit
JehandePoictiers	Jehan de Poictiers
quilàvint,presentlesdiz	qui là vint , present les diz
suppliant,Raillart..etautres,et	suppliant , Raillart . . et autres , et
etdemandale	et demanda le
ditGuillaumeau	dit Guillaume au
ditdePoictiers	dit de Poictiers
quantceavoitestéqueillui	quant ce avoit esté que il lui
devoitavoirdicteslesparolesdevant.declarées,	devoit avoir dictes les paroles devant . declarées ,
lesquellesleditdePoictiersdenyaavoironques	les quelles le dit de Poictiers denya avoir onques
dictesauditsuppliant;etincontinent	dictes au dit suppliant ; et incontinent
incontinentleditsuppliantprouvalesluiavoirdictesen	incontinent le dit suppliant prouva les lui avoir dictes en
lamanierequeditest	la maniere que dit est
estdessus.,et	est dessus . , et
eticellesainsiprouvées,ledit.suppliantdonnaune	et icelles ainsi prouvées , le dit . suppliant donna une
buffeaudit.dePoictiers,pour	buffe au dit . de Poictiers , pour
pourlenyqueilavoitfait	pour le ny que il avoit fait
faitetfaisoitcontreraison.Dont	fait et faisoit contre raison . Dont
Dontledit	Dont le dit
JehandePoictiersfumoult..esmeuetfistson	Jehan de Poictiers fu moult . . esmeu et fist son
povoirdesoy	povoir de soy
soyrevanchierd'uncoustelqueilportoit,	soy revanchier d ' un coustel que il portoit ,
eteustnavréouaffoléledit	et eust navré ou affolé le dit
suppliant,seiln'eustestédetenu	suppliant , se il n ' eust esté detenu
depluseurs	de pluseurs
gensquilàestoient.	gens qui là estoient .
Neantmoins,autremalnenoisen	Neantmoins , autre mal ne noise n
'yot,maisfu	' y ot , mais fu
lapaixincontinentfaicteentreeulx	la paix incontinent faicte entre eulx
,etburent	, et burent
ensembleparbonaccord,comme	ensemble par bon accord , comme
commeilsembloit.Etleditjourde	comme il sembloit . Et le dit jour de
sainctLaurens,que	sainct Laurens , que
leditsuppliant.	le dit suppliant .
et.leditRaillartqui	et . le dit Raillart qui
quiestoientcompaignonsdelongtemps,couchans,levans	qui estoient compaignons de long temps , couchans , levans
levansetbesoingnansensemble,environla	levans et besoingnans ensemble , environ la
nuit,s'	nuit , s '
estoientpartizdelamaisondeleurditmaistre,	estoient partiz de la maison de leur dit maistre ,
pouralercoucherà	pour aler coucher à
unmolinun.	un molin un .
.poloingde	. po loing de
l'ostel	l ' ostel
deleurditmaistre,àquile	de leur dit maistre , à qui le
le..ditmoulinappartenoit	le . . dit moulin appartenoit
etoùilz	et où ilz
avoientaprisàcoucheret	avoient apris à coucher et
alerchascunenuit,etquin'	aler chascune nuit , et qui n '
avoientcoustelne	avoient coustel ne
baston,commeceulzquideriens	baston , comme ceulz qui de riens
riensn'avoientdoubtene	riens n ' avoient doubte ne
quinecuidoientestrehaïsduditde	qui ne cuidoient estre haïs du dit de
dePoictiersned'autres;etquantilz	de Poictiers ne d ' autres ; et quant ilz
furentcommepourpasser.unmurquiest	furent comme pour passer . un mur qui est
entrele	entre le
dithostelduditGuillaumeet	dit hostel du dit Guillaume et
leditmoulin,enun	le dit moulin , en un
angletd'icelluimur,le	anglet d ' icellui mur , le
ditdePoictiersquiestoitunhommeriotteux,batailleux	dit de Poictiers qui estoit un homme riotteux , batailleux
et..hayneuxdepluseurset	et . . hayneux de pluseurs et
commecraintdeceulzdupaïs,estoitlàespiant	comme craint de ceulz du païs , estoit là espiant
et.agaittantyceulx	et . agaittant yceulx
suppliantetRaillart,garnid'	suppliant et Raillart , garni d '
unedemielance	une demie lance
etdeuncoustel	et de un coustel
coustel,et.sitostqu	coustel , et . si tost qu
qu'illesapperçutetquele	qu ' il les apperçut et que le
ditsuppliantpassalepremier	dit suppliant passa le premier
premierledit	premier le dit
angletdemur,quien..riens	anglet de mur , qui en . . riens
nesedonnoitgardeduditde	ne se donnoit garde du dit de
Poictiers,ycelluide.	Poictiers , ycellui de .
.Poictiersdonnaauditsupplianten	. Poictiers donna au dit suppliant en
traïsonet	traïson et
etdefaitadvisiédeladictedemie..lancepar	et de fait advisié de la dicte demie . . lance par
parderriereparledosetluifist	par derriere par le dos et lui fist
fistgrantplaieet	fist grant plaie et
etmehaing,et	et mehaing , et
etcommeprèsd.'avoirestétué;	et comme près d . ' avoir esté tué ;
etledit	et le dit
Raillartquiainsivitson	Raillart qui ainsi vit son
soncompaignonnavréetaffolé,doubtantqueiln'	son compaignon navré et affolé , doubtant que il n '
eneustautant,	en eust autant ,
,..couruàpierresetengectatroisaudit	, . . couru à pierres et en gecta trois au dit
ditde..Poictiers	dit de . . Poictiers
,etpeutestrequeilenattaignysur	, et peut estre que il en attaigny sur
latestesanzplaieoumehaing,etledit	la teste sanz plaie ou mehaing , et le dit
suppliantostaauditdePoictierssademielance.	suppliant osta au dit de Poictiers sa demie lance .
Etlorsleditde	Et lors le dit de
Poictiers,	Poictiers ,
quinevouloit	qui ne vouloit
quehutin	que hutin
etmal,courutauspierres,	et mal , courut aus pierres ,
pourcourirsusaus	pour courir sus aus
ausdizsuppliantet	aus diz suppliant et
Raillart,les	Raillart , les
quelz..n'	quelz . . n '
avoientvoulentédeluimalfaire,	avoient voulenté de lui mal faire ,
etpources'enfouyrent,..sanz	et pour ce s ' en fouyrent , . . sanz
cequ'ilyeustautrechosene	ce qu ' il y eust autre chose ne
nefaitnedit.Etcenonobstant,au	ne fait ne dit . Et ce non obstant , au
matin,l'entrouvaleditdePoictiers	matin , l ' en trouva le dit de Poictiers
mortenunepiecedeterre,onne	mort en une piece de terre , on ne
nescetcommentnepourquoy.Maisneantmoins,	ne scet comment ne pourquoy . Mais neantmoins ,
pourcausedela	pour cause de la
dictebuffedonnéecommeditestetdespierresainsi	dicte buffe donnée comme dit est et des pierres ainsi
gectées,leditsuppliants'estabsenté	gectées , le dit suppliant s ' est absenté
dupaïseten	du païs et en
adventurequejamaisn.'yose	adventure que jamais n . ' y ose
converser,se	converser , se
senostregraceet	se nostre grace et
misericordeneluiestsurceimpartie,	misericorde ne lui est sur ce impartie ,
,ennoussuppliantd'icelle.Nous	, en nous suppliant d ' icelle . Nous
,ceschosesconsideréesetquele	, ces choses considerées et que le
leditsupplianttoutsontempsaestéhommedebonne	le dit suppliant tout son temps a esté homme de bonne
vie,renomméeetconversacionhonneste,sanzavoiresté	vie , renommée et conversacion honneste , sanz avoir esté
reprinsd'autrevilain	reprins d ' autre vilain
casoureproche	cas ou reproche
,sicomme	, si comme
comme.ildit,	comme . il dit ,
,au.ditsuppliantoucas	, au . dit suppliant ou cas
dessusditavonsquicté,remis	dessus dit avons quicté , remis
etpardonné,etc.Sidonnonsen	et pardonné , etc . Si donnons en
mandementparcespresentesaubaillide..	mandement par ces presentes au bailli de . .
Touraineet	Touraine et
desExempcionsd	des Exempcions d
d'Anjou,duMaineetdePoitou,et	d ' Anjou , du Maine et de Poitou , et
àtouznozautresjusticiers,etc.Donnéà	à touz noz autres justiciers , etc . Donné à
Paris,oumoisdemayl'	Paris , ou mois de may l '
andegracemilCCCIIIIXXetXV	an de grace mil CCC IIIIXX et XV
,etleXVedenostreregne.	, et le XVe de nostre regne .
Parleroy,à	Par le roy , à
àlarelacionduconseil.N	à la relacion du conseil . N
N.deVoisines.	N . de Voisines .
