Charles,etc.Savoir..faisons	Charles , etc . Savoir . . faisons
,etc.nousavoirreceul’umble	, etc . nous avoir receu l ’ umble
supplicaciondeBery(sic)Lorin,	supplicacion de Bery ( sic ) Lorin ,
clerc,prisonnierèsprisons	clerc , prisonnier ès prisons
denostreaméet	de nostre amé et
fealconseillerl’evesquedePoictiers,	feal conseiller l ’ evesque de Poictiers ,
,SimonLorin,sonfrere,jeuneshoms,aagié	, Simon Lorin , son frere , jeunes homs , aagié
aagiédexx.ansou	aagié de xx . ans ou
environ,JehandeLavau,simpleshomsdelabour	environ , Jehan de Lavau , simples homs de labour
labour,chargiédefemmeetd’enfans,	labour , chargié de femme et d ’ enfans ,
etdePequinPateau,aussihommedelabour,	et de Pequin Pateau , aussi homme de labour ,
chargiédefemmeetdeseptpetizenfans	chargié de femme et de sept petiz enfans
enfans,tousnatifzdelaparroissede	enfans , tous natifz de la parroisse de
ThuréprèsChastelleraut,contenantque,depuisix	Thuré près Chastelleraut , contenant que , depuis ix
.oux...mois	. ou x . . . mois
moisença,leditMeryLorinfut	mois ença , le dit Mery Lorin fut
assaillyparJehanGirault,	assailly par Jehan Girault ,
ditTriboulemesnaige,PerrinetduChasteigner,	dit Triboulemesnaige , Perrinet du Chasteigner ,
ThibelonFoulquetetparungappelléBerton,autrement	Thibelon Foulquet et par ung appellé Berton , autrement
Ogier,etpar	Ogier , et par
pareulxtelement	par eulx telement
batu,aupourchazd’..	batu , au pourchaz d ’ . .
unappelléHeliotGiraut,freredudit	un appellé Heliot Giraut , frere du dit
Triboulemesnaige.,	Triboulemesnaige . ,
,qu’ilzluifirentxxii.ouxxiii	, qu ’ ilz lui firent xxii . ou xxiii
.playesen..	. playes en . .
sapersonne,..dont	sa personne , . . dont
ilyavoitlesaucunesenlateste,	il y avoit les aucunes en la teste ,
,etentre	, et entre
entrecellesdelatesteluicoupperentou	entre celles de la teste lui coupperent ou
ouprèsuneoreille..,par	ou près une oreille . . , par
parquoyluiquiestoitdeliberéestrehommed’eglise	par quoy lui qui estoit deliberé estre homme d ’ eglise
estinhabille..àjamais	est inhabille . . à jamais
l’estre...	l ’ estre . . .
DonticelluiMeryprinten	Dont icellui Mery print en
luisigrantdesplaisanceetmerencoliequ’	lui si grant desplaisance et merencolie qu ’
ilenestoitcommeàdemy..horsdeson	il en estoit comme à demy . . hors de son
entendement,eta,à	entendement , et a , à
àcausedeladictebateure,	à cause de la dicte bateure ,
estébiensixmois	esté bien six mois
moisaulictmalade.Etdepuixle	mois au lict malade . Et depuix le
leditcasavenu,afaitfairediligenceparjustice	le dit cas avenu , a fait faire diligence par justice
defairepunir	de faire punir
lesdizmalfaiteurs;	les diz malfaiteurs ;
lesquelzenontparlacourtdu	les quelz en ont par la court du
ditlieudeThuréestélonguementdetenuzenprocès	dit lieu de Thuré esté longuement detenuz en procès
procès,oùiladespendu	procès , où il a despendu
despendulargementdusien,etpourceque	despendu largement du sien , et pour ce que
on[n’]enfaisoitexpedicion	on [ n ’] en faisoit expedicion
estoittrèsfortcourroucié	estoit très fort courroucié
,commetoutmerencolieux.Etadvintque,	, comme tout merencolieux . Et advint que ,
luiestantainsicourrouciéet	lui estant ainsi courroucié et
commedeuxou..trois	comme deux ou . . trois
joursaprèsNoel	jours après Noel
,leditMeryestoitou	, le dit Mery estoit ou
oucymetiere..duditlieudeThuré,	ou cymetiere . . du dit lieu de Thuré ,
vitleditJehan.Girautetoyt	vit le dit Jehan . Giraut et oyt
quelecuréouvicairedudit	que le curé ou vicaire du dit
lieulesemonnoitetprioitdesoupperaveclui,	lieu le semonnoit et prioit de soupper avec lui ,
etentenditqueleditJehans’accorda..	et entendit que le dit Jehan s ’ accorda . .
d’yaler	d ’ y aler
,etlors	, et lors
leditMerys’en..ala	le dit Mery s ’ en . . ala
ensamaison	en sa maison
maison,etdistauditSimonLorin	maison , et dist au dit Simon Lorin
Lorin,son	Lorin , son
sonfrere,suppliant,qu’ilpreinst	son frere , suppliant , qu ’ il preinst
ungespieuensamainetalastdire	ung espieu en sa main et alast dire
audit.JehandeLavau,	au dit . Jehan de Lavau ,
,suppliant,soncompere,qu’..il	, suppliant , son compere , qu ’ . . il
ilpreinstsajuisarmeensamain,etquele	il preinst sa juisarme en sa main , et que le
ditGiraultsouppoitavecle	dit Girault souppoit avec le
ditvicaire,et..	dit vicaire , et . .
qu’ilzsevenissentrendreàluiencertaine	qu ’ ilz se venissent rendre à lui en certaine
certainepiecedeterreappartenantà	certaine piece de terre appartenant à
RegnaultLeDoulx..Etaussidistledit	Regnault Le Doulx . . Et aussi dist le dit
MeryauditPequinPateau,suppliant,quiestoit	Mery au dit Pequin Pateau , suppliant , qui estoit
ilec,qu’ilpreinstsa	ilec , qu ’ il preinst sa
juysarmeetalastaveclui,etque	juysarme et alast avec lui , et que
leditJehanGiraultestoitavecledit	le dit Jehan Girault estoit avec le dit
vicaireàsoupper	vicaire à soupper
soupper,etqu’ilz	soupper , et qu ’ ilz
ilz.alassentenladictepiece	ilz . alassent en la dicte piece
piecedeterre,etquelàlesdizJehan	piece de terre , et que là les diz Jehan
deLavauetsonfrere	de Lavau et son frere
sedevoientrendre,ce	se devoient rendre , ce
queleditPequinlui	que le dit Pequin lui
lui..accordadefaire.	lui . . accorda de faire .
.Etdefaitalerentenladictepiece	. Et de fait alerent en la dicte piece
piecedeterre,où	piece de terre , où
lesdizSymon	les diz Symon
SymonLorinetJehandeLavausevindrent	Symon Lorin et Jehan de Lavau se vindrent
rendreà	rendre à
eulx.Etadoncledit	eulx . Et adonc le dit
MeryLorinvadireàtouslesdizautres	Mery Lorin va dire à tous les diz autres
supplianstellesparolesousemblablesensubstance:«Vous	supplians telles paroles ou semblables en substance :« Vous
savezcommentj	savez comment j
j’ayesté.ainsiinjurié,mutilé	j ’ ay esté . ainsi injurié , mutilé
etbatuparlepourchaz	et batu par le pourchaz
de.JehanGiraut.Ilsouppeavecle	de . Jehan Giraut . Il souppe avec le
vicaire.Jevousprie,alons.leguetter	vicaire . Je vous prie , alons . le guetter
guettersursonchemin,quant	guetter sur son chemin , quant
quantilvendraensamaison,etjelui	quant il vendra en sa maison , et je lui
feraysemblablement.	feray semblablement .
.qu’ilm	. qu ’ il m
’afaitfaire».Et	’ a fait faire ». Et
atantsepartirent	atant se partirent
tousensembleet	tous ensemble et
alerentavecleditMeryjusquesen	alerent avec le dit Mery jusques en
unglieu	ung lieu
appeléChampbrenaultqui	appelé Champbrenault qui
estentre	est entre
entrepetizboys,et	entre petiz boys , et
ileclesfistleditMeryembuschier[à]	ilec les fist le dit Mery embuschier [ à ]
]l’oréed’unchemin	] l ’ orée d ’ un chemin
chemin,attendansquantleditGiraultvendroit.Et	chemin , attendans quant le dit Girault vendroit . Et
Etattendirentilecquelquedemyeheure,etpourcequ	Et attendirent ilec quelque demye heure , et pour ce qu
’ilnevenoitpoint,ilz	’ il ne venoit point , ilz
semirentàcheminpoureulxen	se mirent à chemin pour eulx en
enretourner;etainsiqu’ilz	en retourner ; et ainsi qu ’ ilz
s’enretournoient	s ’ en retournoient
retournoient,ilzoyrentbruit..degens,etadoncle	retournoient , ilz oyrent bruit . . de gens , et adonc le
leditMeryva	le dit Mery va
dire:«Veezlecyvenir»,	dire :« Veez le cy venir »,
etsemisticellui	et se mist icellui
Mery[oumilieu]	Mery [ ou milieu ]
du.chemin.	du . chemin .
.Etainsiqu’ilyestoit,[vit]	. Et ainsi qu ’ il y estoit ,[ vit ]
lefilzduditGirautqui	le filz du dit Giraut qui
venoitlepremiercontreleditMery,et	venoit le premier contre le dit Mery , et
demandaquic’	demanda qui c ’
estoit,etleditMeryrespondit	estoit , et le dit Mery respondit
:«Maistoy?»	:« Mais toy ?»
?»Etlorsleditfilz	?» Et lors le dit filz
l’attenditet	l ’ attendit et
disttelles	dist telles
parollesousemblables:«Noussommesmors».	parolles ou semblables :« Nous sommes mors ».
EtleditJehans’avançapourvenirau	Et le dit Jehan s ’ avança pour venir au
aucrydesondit	au cry de son dit
ditfilz.Etquant	dit filz . Et quant
leditMeryvitqu	le dit Mery vit qu
’ilfuten	’ il fut en
sonavantaige..,	son avantaige . . ,
iltira.uneespéequ’	il tira . une espée qu ’
ilavoitetendonnaaudit.Jehan	il avoit et en donna au dit . Jehan
Giraultungcop	Girault ung cop
surlateste,dontilcheut	sur la teste , dont il cheut
àterre,etenaprès.le	à terre , et en après . le
ditMery..luidonnaungautre	dit Mery . . lui donna ung autre
copoudeuxpar	cop ou deux par
lesjambes,etles	les jambes , et les
lesdizautressupplians.	les diz autres supplians .
.aussifrapperentsur	. aussi frapperent sur
lui,sanscequ’ilz..saichent	lui , sans ce qu ’ ilz . . saichent
saichentproprement,pource..	saichent proprement , pour ce . .
.queonneveoytgoute,parquel	. que on ne veoyt goute , par quel
quelendroitcefut,etlebatirent	quel endroit ce fut , et le batirent
trèsfort.	très fort .
etatantsedepartirent	et atant se departirent
,nonsaichansqu’	, non saichans qu ’
ilfustmort	il fust mort
,mais.cuidansnel	, mais . cuidans ne l
’avoir.que	’ avoir . que
batu...Ettoutesvoyesilleur	batu . . . Et toutesvoyes il leur
aestérapporté	a esté rapporté
qu’ilaesté	qu ’ il a esté
trouvétout.mort	trouvé tout . mort
mortenlaplace	mort en la place
place.Depuislequel	place . Depuis lequel
casavenu,le	cas avenu , le
ditJehandeLavaufutprinsprisonnieretmenéès	dit Jehan de Lavau fut prins prisonnier et mené ès
prisonsdeChastellerault,deparleditevesque	prisons de Chastellerault , de par le dit evesque
dePoictiers,commeseigneurtemporelethault	de Poictiers , comme seigneur temporel et hault
justicierdu	justicier du
ditlieudeThuré.Etledit	dit lieu de Thuré . Et le dit
Meryfut	Mery fut
futtantostaprèsaussiprinsparcestevillede	fut tantost après aussi prins par ceste ville de
Chinon,oùilestoitvenuversnous	Chinon , où il estoit venu vers nous
pourchassersagraceet	pourchasser sa grace et
remission..etcelledes	remission . . et celle des
dizautressupplians,etmis	diz autres supplians , et mis
èsprisonsduditlieude	ès prisons du dit lieu de
Chinonparleprevostdenozmareschaulx;	Chinon par le prevost de noz mareschaulx ;
desquellesilaesté..rendu	des quelles il a esté . . rendu
auditevesquedePoictiers,	au dit evesque de Poictiers ,
commesonclerc,quidepresentletient	comme son clerc , qui de present le tient
ensesprisons.Etsontlesdiz	en ses prisons . Et sont les diz
deLavauetLorinencoresdetenuzèsprisonsdu	de Lavau et Lorin encores detenuz ès prisons du
ditevesquede	dit evesque de
Poictiers,oùilzsontendangierdefiner	Poictiers , où ilz sont en dangier de finer
miserablement..leursjours.Et	miserablement . . leurs jours . Et
lesdizSimon..	les diz Simon . .
Lorinet	Lorin et
Pequin.Pasteaus’ensontfouyzet	Pequin . Pasteau s ’ en sont fouyz et
etabsentezdu	et absentez du
pays,etn’..yoseroientjamaisrepairerne	pays , et n ’ . . y oseroient jamais repairer ne
converser,se	converser , se
nozgraceetmisericorde	noz grace et misericorde
neleurestoientsurceimparties,si	ne leur estoient sur ce imparties , si
sicommedientlesdiz..supplians.Etpource	si comme dient les diz . . supplians . Et pour ce
cenousonticeulxsupplianshumblement	ce nous ont iceulx supplians humblement
suppliéetrequisque,attendu	supplié et requis que , attendu
lamutilaciondudit	la mutilacion du dit
MeryLorin,lajeunessede	Mery Lorin , la jeunesse de
sonditfrere,qu’il	son dit frere , qu ’ il
n’aquexx.ans	n ’ a que xx . ans
ans,commedit	ans , comme dit
est,etaussi	est , et aussi
enpitiéet.compassiondesfemmesetenfansdes	en pitié et . compassion des femmes et enfans des
dizautresdeuxsupplians,et	diz autres deux supplians , et
quejamais	que jamais
jamaisiceulxsuppliansne	jamais iceulx supplians ne
aucunsd’eulx..	aucuns d ’ eulx . .
.nefurentreprins,convaincuzoucondempnezd’	. ne furent reprins , convaincuz ou condempnez d ’
aucunautrevilaincas	aucun autre vilain cas
,blasmeou.reprouche,ainsont	, blasme ou . reprouche , ains ont
ontestéetsont	ont esté et sont
sontentousautrescasbienfamezet	sont en tous autres cas bien famez et
etrenommez,nousleurvueillons..surce	et renommez , nous leur vueillons . . sur ce
impartirnosd.graceetmisericorde.Pourquoy	impartir nosd . grace et misericorde . Pour quoy
nous,inclinansàlasupplicaciondesdizsupplians,	nous , inclinans à la supplicacion des diz supplians ,
voulansmisericorde	voulans misericorde
prefereràrigueurde	preferer à rigueur de
justice,etc.,leuravonsremis,	justice , etc ., leur avons remis ,
quictezetpardonnez	quictez et pardonnez
,etc.Si	, etc . Si
donnonsenmandementpar	donnons en mandement par
parcespresentes	par ces presentes
presentesànoz	presentes à noz
seneschaldePoictouetbaillideTouraineetdes	seneschal de Poictou et bailli de Touraine et des
ressorsetExempcionsd.’Anjouet	ressors et Exempcions d . ’ Anjou et
duMaine,etàtousnozautresjusticiers,	du Maine , et à tous noz autres justiciers ,
,etc.Et..	, etc . Et . .
pourcequelesdizsupplians,quisont	pour ce que les diz supplians , qui sont
plusieurs,pourroientavoiràbesoingnerdecespresentes	plusieurs , pourroient avoir à besoingner de ces presentes
chascunàparsoyetendiverslieux,nous	chascun à par soy et en divers lieux , nous
voulonsque	voulons que
auvidimusd’icelles,faitsoubzseel	au vidimus d ’ icelles , fait soubz seel
royal,plainefoysoitadjoustée	royal , plaine foy soit adjoustée
commeàl’original.Donné	comme à l ’ original . Donné
àChinon,oumoisdejanvier	à Chinon , ou mois de janvier
janvierl’andegracemiliiiic	janvier l ’ an de grace mil iiiic
iiiicxlv,etdenostreregnelexxiiiie.Ainsi	iiiic xlv , et de nostre regne le xxiiiie . Ainsi
signé:Par	signé : Par
leroy,monseigneur	le roy , monseigneur
ledaulphin,..leconte	le daulphin , . . le conte
deFoix,.vous,l	de Foix , . vous , l
l’arcevesque..de	l ’ arcevesque . . de
Reims,lessrsdelaVarenne	Reims , les srs de la Varenne
,dePressignyetdeMaupas,etautres	, de Pressigny et de Maupas , et autres
presens.Giraudeau.—	presens . Giraudeau .—
Visa.Contentor	Visa . Contentor
.E.Duban.	. E . Duban .
