Charles,etc...Savoirfaisonsàtous,	Charles , etc . . . Savoir faisons à tous ,
,presenset	, presens et
etavenir,nousavoir.receu	et avenir , nous avoir . receu
l'umblesupplicacion	l ' umble supplicacion
desamischarnel.deJaquesdeSaintGelays,	des amis charnel . de Jaques de Saint Gelays ,
,deJehanRogre,filzde	, de Jehan Rogre , filz de
feuJehanRogre,deBieaulieu,escuiers	feu Jehan Rogre , de Bieaulieu , escuiers
escuiers,etJehanleGaschier,autrementditJaquart	escuiers , et Jehan le Gaschier , autrement dit Jaquart
,contenantquecomme[	, contenant que comme [
entre]unappelleMathelindeGascoignoleetle	entre ] un appelle Mathelin de Gascoignole et le
ditJehanGaschiersefeussentmeucertaindebat	dit Jehan Gaschier se feussent meu certain debat
sur.etpour	sur . et pour
causedecequeleditMathelin	cause de ce que le dit Mathelin
disoitavoirvenduàicelluiJehanGaschier	disoit avoir vendu à icellui Jehan Gaschier
Gaschiercertainequantitéde	Gaschier certaine quantité de
vins..etdeblé,	vins . . et de blé ,
,.dontilluienavoitbailliéou	, . dont il lui en avoit baillié ou
oufaitbaillierunepartie,..etl'autre	ou fait baillier une partie , . . et l ' autre
partieestoitprest	partie estoit prest
deluibailler	de lui bailler
parmicequeleditJehanGraschier	parmi ce que le dit Jehan Graschier
Graschierluipaiastauprisauquelilleluiavoitvendu	Graschier lui paiast au pris auquel il le lui avoit vendu
vendu.Aquoyrespondoit	vendu . A quoy respondoit
icelluiJehanGaschierquevoulentiersle	icellui Jehan Gaschier que voulentiers le
paieroitdecequ'illuiavoit	paieroit de ce qu ' il lui avoit
estébailliéet.	esté baillié et .
.livré,maisauregartdecequ	. livré , mais au regart de ce qu
'iln'avoit	' il n ' avoit
avoiteu,disoitqueplusnelerecevroitneaucune	avoit eu , disoit que plus ne le recevroit ne aucune
chosen'	chose n '
enpaieroit.au	en paieroit . au
auditMathelin,atenduquebaillier	au dit Mathelin , atendu que baillier
[ou]livrer	[ ou ] livrer
leluidevoit	le lui devoit
dedenscertaintemps,cequeiln'avoit	dedens certain temps , ce que il n ' avoit
avoitpasfait	avoit pas fait
,donticellui	, dont icellui
icelluiGaschieravoitestéetestoit	icellui Gaschier avoit esté et estoit
grandementendommaigié,.ettantfut	grandement endommaigié , . et tant fut
procedéouditdebatqueenhayne	procedé ou dit debat que en hayne
etcontentdecequeditest,	et content de ce que dit est ,
,ouautrement,icellui	, ou autrement , icellui
Mathelindonnapluseursgransmenacesau	Mathelin donna pluseurs grans menaces au
ditGaschierdelebatreetvillener,s	dit Gaschier de le batre et villener , s
s'illepovoitrencontreràsonavantaige.	s ' il le povoit rencontrer à son avantaige .
.Pourlesquellesmenaces,icelluiGaschierfu	. Pour lesquelles menaces , icellui Gaschier fu
moltespoantezettelementqu'..	molt espoantez et telement qu ' . .
iln'osoit.alerseurementàsesbesongnes	il n ' osoit . aler seurement à ses besongnes
etaffaires,ainsiqu	et affaires , ainsi qu
'ilavoitaccoustuméparavant,pour	' il avoit accoustumé par avant , pour
doubted	doubte d
'icellui.Mathelinquiestoitgrantetpuissant	' icellui . Mathelin qui estoit grant et puissant
puissantde..corps,attendu	puissant de . . corps , attendu
aussiqu'ilestoitde	aussi qu ' il estoit de
mauvaiserenomméeetdegrant	mauvaise renommée et de grant
hardementdefoleentreprise,etquivolontiersprocedoitpar	hardement de fole entreprise , et qui volontiers procedoit par
voyedefait,et..mesmementqu'ilavoit	voye de fait , et . . mesmement qu ' il avoit
occisunhommeenvironMelle,	occis un homme environ Melle ,
,etavecceavoitbatu..	, et avec ce avoit batu . .
..etvillenéaucunsgentilzhommes	. . et villené aucuns gentilz hommes
d'iceluipays	d ' icelui pays
pays,et	pays , et
aloitaussicontinuelment..garnyd'	aloit aussi continuelment . . garny d '
'espéeetdedague	' espée et de dague
dague.Siadvintque	dague . Si advint que
iceluiJehanGaschiertrouvaleditJaquesàBrueillebon,	icelui Jehan Gaschier trouva le dit Jaques à Brueillebon ,
,lejeudiavantlafestedesaintJehanBaptiste	, le jeudi avant la feste de saint Jehan Baptiste
derrenierementpassée,ouquellieu	derrenierement passée , ouquel lieu
lieusurvint.leditJehanRogre,frerede	lieu survint . le dit Jehan Rogre , frere de
lafemmeduditGaschier,etlaquelle	la femme du dit Gaschier , et laquelle
laquellefemmed'icelui	laquelle femme d ' icelui
Gaschierestoit	Gaschier estoit
etest..prouchaineparente	et est . . prouchaine parente
parentedelafemmed'iceluiJaques;	parente de la femme d ' icelui Jaques ;
;ausquelxJaqueset..Rogre	; aus quelx Jaques et . . Rogre
RogreleditGaschier,	Rogre le dit Gaschier ,
pourl'affinitéqu'	pour l ' affinité qu '
'ilavoitàeulxpourcausedu	' il avoit à eulx pour cause du
parentédessusdit,exposasoncas,enles	parenté dessus dit , exposa son cas , en les
priantqu'ilzluifeussentaidablesà	priant qu ' ilz lui feussent aidables à
resisteràla	resister à la
mauvaisevolonté	mauvaise volonté
volontéduditMathelin,affinqueplus	volonté du dit Mathelin , affin que plus
plusyceluiGaschier	plus ycelui Gaschier
Gaschiernefeustendoubte	Gaschier ne feust en doubte
delui;carautrement	de lui ; car autrement
autrementilnepourroitestreasseurdesoncorps,pour	autrement il ne pourroit estre asseur de son corps , pour
doubted'iceluiMathelin.La	doubte d ' icelui Mathelin . La
quellechoseyceulxJaquesetRogreluiaccorderent	quelle chose yceulx Jaques et Rogre lui accorderent
ets'enalerentensemble,le	et s ' en alerent ensemble , le
leditjour	le dit jour
de.jeudi,à	de . jeudi , à
couchieràTernentueil,enl'ostel.dudit	couchier à Ternentueil , en l ' ostel . du dit
JehanRogre	Jehan Rogre
Rogre,etlevenrediensuivant,veilledeladicte	Rogre , et le venredi ensuivant , veille de la dicte
festede	feste de
saintJehan	saint Jehan
,environlepointdu	, environ le point du
jour,separtirenttous	jour , se partirent tous
toustroisdu	tous trois du
duditlieudeTernentueil,garnizc	du dit lieu de Ternentueil , garniz c
'estassavoirledit.Jaquesd'une	' est assavoir le dit . Jaques d ' une
cotedefer,d	cote de fer , d
d'uneespée	d ' une espée
etd'unbaston	et d ' un baston
,etledit	, et le dit
ditJehanGaschierd'un	dit Jehan Gaschier d ' un
bazelaireetd'unautrebaston,etalerent	bazelaire et d ' un autre baston , et alerent
versl'ostel.delaTaillée	vers l ' ostel . de la Taillée
Tailléeprèsdu	Taillée près du
villaged'Androullet.,où	village d ' Androullet . , où
oùdemouroityceluiMathelin,etpasserentpar	où demouroit ycelui Mathelin , et passerent par
devantledithosteletalerentjusquesauprèsd	devant le dit hostel et alerent jusques auprès d
d'unmoulinappellélemoulin	d ' un moulin appellé le moulin
deRoches,eteneulx	de Roches , et en eulx
eulx:tournant,rencontrerentleditMathelin	eulx : tournant , rencontrerent le dit Mathelin
Mathelin,auquelildistrentqu'ilsedeffendist	Mathelin , au quel il distrent qu ' il se deffendist
;lequelsachauneespée	; lequel sacha une espée
qu'ilavoitpoursoydefendre	qu ' il avoit pour soy defendre
defendred'euls.EtlorsleditJaquesassemblaà..	defendre d ' euls . Et lors ledit Jaques assembla à . .
luietlevoultferirdesonbastonsur	lui et le voult ferir de son baston sur
lateste;maisle	la teste ; mais le
ditMathelinprint	dit Mathelin print
printsadicteespéeàdeux	print sa dicte espée à deux
mainsetengettaunsigrantcopcontre	mains et en getta un si grant cop contre
contrelebastondudit	contre le baston du dit
Jaquesqu..'	Jaques qu . . '
'ilcouppaleditbastonetferyyceluiJaques	' il couppa le dit baston et fery ycelui Jaques
parmilebras,	parmi le bras ,
tantqu'illuifistunegrantplaye	tant qu ' il lui fist une grant playe
ouditbras.LequelJaquesveantqu'il	ou dit bras . Lequel Jaques veant qu ' il
estoitainsiblecié,setrayunpouarriereet	estoit ainsi blecié , se tray un pou arriere et
printunepierre,	print une pierre ,
laquelleilgettaversleditMathelinet	laquelle il getta vers le dit Mathelin et
l'enattaingnyparmilatestetant	l ' en attaingny parmi la teste tant
tantqu'illefistcheoiràterre.	tant qu ' il le fist cheoir à terre .
Laquellechosefaicte,lesdessusnommez,esmeuz	Laquelle chose faicte , les dessus nommez , esmeuz
esmeuzetcourciezplus..quedevantde	esmeuz et courciez plus . . que devant de
delableceurequeiceluiMathelinavoitfaicteau	de la bleceure que icelui Mathelin avoit faicte au
auditJaques,lebatirentetnavrerent.	au dit Jaques , le batirent et navrerent .
deleursdiz	de leurs diz
dizbastonsetespées,	diz bastons et espées ,
etluiosterent	et lui osterent
sonespéeetsa	son espée et sa
sadague,et	sa dague , et
etlegetterentenlarivierede	et le getterent en la riviere de
laSoyvrequiestoitjoingnantd'	la Soyvre qui estoit joingnant d '
'illec,ettellementlebatirent	' illec , et tellement le batirent
et..navrerentquepour	et . . navrerent que pour
occasiondeladictebateureet	occasion de la dicte bateure et
navreure.iltrespassalelendemainensuivant,jour	navreure . il trespassa le lendemain ensuivant , jour
defeste.saintJehan.Maisavantqu'	de feste . saint Jehan . Mais avant qu '
iltrespassast,ilfu..confezet	il trespassast , il fu . . confez et
parlajusquesassezprès..	parla jusques assez près . .
desontrespassement.Pourcausedu	de son trespassement . Pour cause du
quelcaslesdiz	quel cas les diz
dizJaques,.Rogre	diz Jaques , . Rogre
RogreetGaschierontesté..	Rogre et Gaschier ont esté . .
appeliezausdroiz	appeliez aus droiz
droizdejustice,etpourcese	droiz de justice , et pour ce se
sontabsentezdupaïs,et	sont absentez du païs , et
jamaisn'yoseroientretourner,ainçois..	jamais n ' y oseroient retourner , ainçois . .
seroientenaventured	seroient en aventure d
'enestreexiliez,etqueeulx	' en estre exiliez , et que eulx
etlesfemmesdes	et les femmes des
dizJehan.Gaschier	diz Jehan . Gaschier
etJaques.deSaint	et Jaques . de Saint
Gelaizfeussentdesersàtousjours,separ	Gelaiz feussent desers à tousjours , se par
nousneleurestoitsurceimpartienostregrace	nous ne leur estoit sur ce impartie nostre grace
.Ennoushumblementrequerantque,	. En nous humblement requerant que ,
considerélesbonsetaggreablesservices	consideré les bons et aggreables services
queiceluiJaqueset	que icelui Jaques et
sespredecesseursontfaitànousetànozpredecesseurs	ses predecesseurs ont fait à nous et à noz predecesseurs
,oufaitet	, ou fait et
exercicede	exercice de
denozguerres	de noz guerres
,oùilzontfrayéetdespendu.la	, où ilz ont frayé et despendu . la
plusgrantpartiedeleurschevances,	plus grant partie de leurs chevances ,
,etquelesdizJaques,RogreetGaschiern	, et que les diz Jaques , Rogre et Gaschier n
'avoient	' avoient
pasvolonténe..entenciondetueryceluiMathelin	pas volonté ne . . entencion de tuer ycelui Mathelin
,nousvueillonsenverseulxestre	, nous vueillons envers eulx estre
estrepiteablesetmisericors.Pourquoynous,attenduce	estre piteables et misericors . Pour quoy nous , attendu ce
queditest,etlarequesteetpryerede	que dit est , et la requeste et pryere de
nostretrèschierettrèsaméfrerele	nostre très chier et très amé frere le
ducd'Orléans,quidecenousa	duc d ' Orléans , qui de ce nous a
faittrès..humblement	fait très . . humblement
humblementsupplier.etrequerir	humblement supplier . et requerir
,ausdizJaquesdeSaint	, aus diz Jaques de Saint
Gelais,JehanRogreetJehan	Gelais , Jehan Rogre et Jehan
Gaschier,etàchascund'eulx..,	Gaschier , et à chascun d ' eulx . . ,
,oucasdessusdit,avonsquicté,remiset	, ou cas dessusdit , avons quicté , remis et
etpardonné,etc.Sidonnonsenmandementparla	et pardonné , etc . Si donnons en mandement par la
teneurdeces	teneur de ces
cesprésentesauseneschal..de	ces présentes au seneschal . . de
deXanctongeetàtousnozautresjusticiers	de Xanctonge et à tous noz autres justiciers
,etc.Donné	, etc . Donné
àParis,oumois	à Paris , ou mois
dejuillet.	de juillet .
l'andegrace	l ' an de grace
gracemilCCCCetdeux,etdenostre..regnele	grace mil CCCC et deux , et de nostre . . regne le
XXIIe.Parleroy	XXIIe . Par le roy
,messireGuillaumeMartel,lesire	, messire Guillaume Martel , le sire
deChambrilhat	de Chambrilhat
Chambrilhatetautres	Chambrilhat et autres
autrespresens.R.Toste	autres presens . R . Toste
