Jehan,par..la	Jehan , par . . la
lagracedeDieu	la grace de Dieu
,roydeFrance.Savoirfaisonsà	, roy de France . Savoir faisons à
touspresensetavenirque,commeparmi	tous presens et avenir que , comme par mi
letraitiédelapaisetaccortfaizentrenous	le traitié de la pais et accort faiz entre nous
nouset..nostretrèschierfrerele	nous et . . nostre très chier frere le
royd'Angleterre,toutesmanieresdegens	roy d ' Angleterre , toutes manieres de gens
gensnossubgezetde	gens nos subgezet de
nostreobeissance,dequelconquecondicionouestatqu	nostre obeissance , de quelconque condicion ou estat qu
'ilsoient,quidurantlesguerres	' il soient , qui durant les guerres
auronttenulepartidenostreditfrerecontre	auront tenu le parti de nostre dit frere contre
nous,et	nous , et
aussisemblablement	aussi semblablement
toutesmanieresde	toutes manieres de
gens,subgezetdel'obeissance	gens , subgez et de l ' obeissance
denostreditfrere,qui	de nostre dit frere , qui
quiauroienttenunostreparticontre	qui auroient tenu nostre parti contre
lenostreditfrere,	le nostre dit frere ,
doivent.retourner	doivent . retourner
etestrerestituezàleursterres,païs	et estre restituez à leurs terres , païs
,possescions,biens,rentesetrevenuez	, possescions , biens , rentes et revenuez
quelconques,donnéesetoccuppées	quelconques , données et occuppées
occuppéesparl'une..partie	occuppées par l ' une . . partie
partieetparl'	partie et par l '
autre.,et	autre . , et
etavecquesceleursontpardonné,	et avecques ce leur sont pardonné ,
,remis.etquitiétouzmeffaiz,rencunesetindignacionsquelconques	, remis . et quitié touz meffaiz , rencunes et indignacions quelconques
quelconques;etilsoitainsique	quelconques ; et il soit ainsi que
quenostreaméetfealleseigneurdeClichon,	que nostre amé et feal le seigneur de Clichon ,
durantlesditesguerresaitestéaherant	durant les dites guerres ait esté aherant
aherantetaliéettenulepartidenostre	aherant et alié et tenu le parti de nostre
nostredit.frerecontrenous	nostre dit . frere contre nous
,.pourquoilechastel,	, . pour quoi le chastel ,
lachastelerieet	la chastelerie et
etvillede	et ville de
delaGarnacheavecquesses	de la Garnache avecques ses
sesappartenancesetlavillede	ses appartenances et la ville de
deBeauvoiretsesappartenances,	de Beauvoir et ses appartenances ,
etlaterrequ'iltenoitàChatonsseaux	et la terre qu ' il tenoit à Chatonsseaux
oucomtéd'Anjou,appartenansaudit	ou comté d ' Anjou , appartenans au dit
siredeClichon,ettoutessesautresterres,	sire de Clichon , et toutes ses autres terres ,
,rentes,possessionset	, rentes , possessions et
etrevenuesestansennostreroyaume,aientestéprises	et revenues estans en nostre royaume , aient esté prises
parnous..commeconfisquésetfourfais	par nous . . comme confisqués et fourfais
.Nous,voullansteniretacomplir	. Nous , voullans tenir et acomplir
acomplirladitepaisetacorten	acomplir la dite pais et acort en
lafourme	la fourme
fourmeetmanierequeaccordéest	fourme et maniere que accordé est
est,avonsrandu,delivréetrestitué	est , avons randu , delivré et restitué
restitué,randons.,delivronset	restitué , randons . , delivrons et
restituonsparcespresentesauditseigneurdeClichon	restituons par ces presentes au dit seigneur de Clichon
touteslesterresdessusdites..ettoutezsesautresterres	toutes les terres dessus dites . . et toutez ses autres terres
terres,possessions,rentezetrevenuezestans	terres , possessions , rentez et revenuez estans
estansennostreroyaume,quià	estans en nostre royaume , qui à
ànousappartendroientparquelconquemanierequecesoit,.	à nous appartendroient par quelconque maniere que ce soit , .
pourlescausesdessusdictes,nonobstantquelconques	pour les causes dessus dictes , non obstant quelconques
donsetalienacions	dons et alienacions
d'icellesterres	d ' icelles terres
,parnousou	, par nous ou
parnostretrèschieretaméfilz,leduc	par nostre très chier et amé filz , le duc
deNormendie..,ouautresquelconquesfaitezsoubz	de Normendie . . , ou autres quelconques faitez soubz
quelconquefourmedeparoulez,lesquiexdonset	quelconque fourme de paroulez , les quiex dons et
alienacions,s'aucunessontfaites,nous	alienacions , s ' aucunes sont faites , nous
rappellonsetrevonsonsquonsdutout.	rappellons et revonsons quons du tout .
Sidonnonsenmandementauxsegnechauxd	Si donnons en mandement aux segnechaux d
'AnjouetdePoito,	' Anjou et de Poito ,
et.àtouzlesautresjusticiersetofficiersdenostre	et . à touz les autres justiciers et officiers de nostre
nostreroyaume,presensetavenir,ou	nostre royaume , presens et avenir , ou
ouàleurslieus	ou à leurs lieus
lieustenansetàchascund'	lieus tenans et à chascun d '
'eus,sicommeàluiapartendra,que	' eus , si comme à lui apartendra , que
auditsire	au dit sire
deClichonouàsoncertaincommandemant	de Clichon ou à son certain commandemant
baillentetdelivrent,rendent	baillent et delivrent , rendent
etrestituent	et restituent
lesterresdessusditesetchascuned	les terres dessus dites et chascune d
'icelles	' icelles
,ouquasqu'ellesne	, ou quas qu ' elles ne
neseroientdelaterredeBelleVilleetdesappartenances	ne seroient de la terre de Belle Ville et des appartenances
d'icelles.	d ' icelles .
.,etd'icellezlui	. , et d ' icellez lui
,seshoirsettousceulxquidelui	, ses hoirs et tous ceulx qui de lui
ontoupouroientavoircauseou	ont ou pouroient avoir cause ou
outempsavenir,facent	ou temps avenir , facent
etlaissentjoiretuser,	et laissent joir et user ,
,sanzaucun..	, sanz aucun . .
empeschementoucontredit,enlafourme	empeschement ou contre dit , en la fourme
etmanierequeluietsespredecesseursfaissoientparavent	et maniere que lui et ses predecesseurs faissoient par avent
lesdictes	les dictes
guerez,encontraignant.adceviguereusement	guerez , en contraignant . ad ce viguereusement
etsansaucundeport	et sans aucun deport
touslestenansetoccupansles	tous les tenans et occupans les
ditesterresetchascuned	dites terres et chascune d
'icelles.Toutevoye	' icelles . Toutevoye
Toutevoyenostreantancion	Toutevoye nostre antancion
n'..estpasqueles	n ' . . est pas que les
distenansouoccupansicellesterressoienten..	dis tenans ou occupans icelles terres soient en . .
aucunemanierecontraintdederandreourestituerce	aucune maniere contraint de de randre ou restituer ce
cequepourle	ce que pour le
tempsdesdictesguerresontdesdictes	temps des dictes guerres ont des dictes
dictesrentezetrevenuezreceuetlevé.Et.	dictes rentez et revenuez receu et levé . Et .
.quecesoitfermechouseet.estableà	. que ce soit ferme chouse et . estable à
tousjours,	tousjours ,
,nousavonsfaitmettrenostre..scellàcespresentes	, nous avons fait mettre nostre . . scell à ces presentes
presentes.Saufnostredroitenautreschouses	presentes . Sauf nostre droit en autres chouses
etl'autruy.entoutez.	et l ' autruy . en toutez .
.DonnéàParis	. Donné à Paris
,l'andegracemilccc.	, l ' an de grace mil ccc .
lxi,oumoisdeseptembre	lxi , ou mois de septembre
.Parleroy,àla	. Par le roy , à la
larelacionduconseilestantàParis.J.	la relacion du conseil estant à Paris . J .
