Charles,par.lagracedeDieu	Charles , par . la grace de Dieu
roydeFrance.Savoir	roy de France . Savoir
faisons.àtous,presensetavenir,que	faisons . à tous , presens et avenir , que
dela.partieJehanduVergieret	de la . partie Jehan du Vergier et
NicolasduVergier,.sonfils,nous	Nicolas du Vergier , . son fils , nous
nousaestéexposéque	nous a esté exposé que
,commeleditNicolas,du	, comme le dit Nicolas , du
consentement,accortetvolenté	consentement , accort et volenté
volentéduditJehan	volenté du dit Jehan
sonpereetdesafemme,jadisfemme	son pere et de sa femme , jadis femme
femmedefeuJehan	femme de feu Jehan
JehanPain,eulxtraictanset	Jehan Pain , eulx traictans et
etprocuranssurce	et procurans sur ce
,aitcontrait	, ait contrait
,depuislemoisdeseptembrederrenier..passé	, depuis le mois de septembre derrenier . . passé
,mariageavecJehannePaine,	, mariage avec Jehanne Paine ,
,maindrededouzeansàpresent,fille	, maindre de douze ans à present , fille
deladictefemmeet	de la dicte femme et
etdudit	et du dit
JehanPain,jadisson	Jehan Pain , jadis son
mari,letuteurd'icellefilleà	mari , le tuteur d ' icelle fille à
cenonappelléetcontredisant,etpourceque	ce non appellé et contredisant , et pour ce que
icellefillepourcausedesaminoritéestoitlorsen	icelle fille pour cause de sa minorité estoit lors en
nostre.tuicion	nostre . tuicion
etgarde,comme.	et garde , comme .
.lesautresdesacondicion,meneursd'	. les autres de sa condicion , meneurs d '
ans,sontetdoivent	ans , sont et doivent
estre,ildoubtentquepourletempsavenir	estre , il doubtent que pour le temps avenir
ilenpeussentpar.aucunsde	il en peussent par . aucuns de
nosjusticiers,	nos justiciers ,
gensouofficiers	gens ou officiers
officiers,estrepoursuiz,empeschiez,outraictés	officiers , estre poursuiz , empeschiez , ou traictés
traictésetcontrainsàamende.	traictés et contrains à amende .
Sinousonthumblementsuppliéque,commeledit	Si nous ont humblement supplié que , comme le dit
mariagesoitainsi	mariage soit ainsi
faitetentierementconsummé,et	fait et entierement consummé , et
queleditJehanduVergier	que le dit Jehan du Vergier
nousait.servibien	nous ait . servi bien
etloyaumentennosderrenieresguerresetfais,	et loyaument en nos derrenieres guerres et fais ,
depuisquelepaïs.	depuis que le païs .
dePoitou,làoùilsontestéet	de Poitou , là où ils ont esté et
etsontdemourans,.	et sont demourans , .
se..tourna	se . . tourna
ànostrebonneobeissance,quenous	à nostre bonne obeissance , que nous
leurvuillionsremettreetpardonnertoutce	leur vuillions remettre et pardonner tout ce
queilspeventou..pourroientpourcause	que ils pevent ou . . pourroient pour cause
deceavoir	de ce avoir
meffaitoumesprisenversnous.Nousadecertes	meffait ou mespris envers nous . Nous adecertes
,inclinansàleursupplication	, inclinans à leur supplication
,.attendueset	, . attendues et
consideréesleschosesdessusdictes,ausdessus	considerées les choses dessus dictes , aus dessus
dessusdisJehan,safemmeet	dessus dis Jehan , sa femme et
Nicolas,etàchascund	Nicolas , et à chascun d
'eulx,touteoffenseetamendecivileou	' eulx , toute offense et amende civile ou
quelconque.,	quelconque . ,
,quepour	, que pour
causeetoccasiondeceil	cause et occasion de ce il
ilpeventestreou	il pevent estre ou
avoirencouruenvers	avoir encouru envers
enversnous,avonsremis,quictiéetpardonné,et	envers nous , avons remis , quictié et pardonné , et
parlateneurdecespresentes,de	par la teneur de ces presentes , de
nostrecertainescience	nostre certaine science
,graceespecialetauctorité	, grace especial et auctorité
royal,remettons	royal , remettons
remettons,quictonsetpardonnonsoucasdessusdit.Si	remettons , quictons et pardonnons ou cas dessus dit . Si
donnonsenmandementparcesmeismes.presentesàtous	donnons en mandement par ces meismes . presentes à tous
tousseneschaus,baillis,.	tous seneschaus , baillis , .
.prevosts,commissaires,menistres,procureursetàtous	. prevosts , commissaires , menistres , procureurs et à tous
touslesautresjusticierset	tous les autres justiciers et
officiersdenostreroyaume,ouàleurs	officiers de nostre royaume , ou à leurs
lieuxtenans,presensetavenir,et	lieuxtenans , presens et avenir , et
àchascund'eulx,si.commeàlui	à chascun d ' eulx , si . comme à lui
appartendra,quedenostre.presentegracefacent,	appartendra , que de nostre . presente grace facent ,
seuffrentetlaissentles.	seuffrent et laissent les .
dessusdisJehan,safemmeet	dessus dis Jehan , sa femme et
Nicolas,etchascund'eulxjoiretuser	Nicolas , et chascun d ' eulx joir et user
plainementetpaisiblement,sansaucuncontredit..Etleur	plainement et paisiblement , sans aucun contredit . . Et leur
imposonssurcesilenceperpetuel,et	imposons sur ce silence perpetuel , et
etdeffendonsestroictementquecontrelateneurdenostredicte	et deffendons estroictement que contre la teneur de nostre dicte
gracene	grace ne
lesempeschent,molestentou..travaillent,	les empeschent , molestent ou . . travaillent ,
neseuffrentestre	ne seuffrent estre
empeschez,molestezoutravaillezencorpsne	empeschez , molestez ou travaillez en corps ne
enbiens.aucunement;	en biens . aucunement ;
;messeaucunechoseestoitou	; mes se aucune chose estoit ou
avoitestéfaitaucontraire,queil	avoit esté fait au contraire , que il
illeremettent.oufacentremettre	il le remettent . ou facent remettre
aupremierestatetdeu	au premier estat et deu
.Etpourcequecesoitfermechoseet	. Et pour ce que ce soit ferme chose et
etestableà..tousjours,nousavons	et estable à . . tousjours , nous avons
faitmettrenostre	fait mettre nostre
seelàcespresenteslettres.DonnéàParis	seel à ces presentes lettres . Donné à Paris
Paris,ennostrechastelduLouvrel'an	Paris , en nostre chastel du Louvre l ' an
degracemiltroiscenssoixantedouze,et	de grace mil trois cens soixante douze , et
denostreregneleixe..,	de nostre regne le ixe . . ,
oumoisde	ou mois de
dejanvier.	de janvier .
Chanac.—	Chanac .—
Parleroyenses	Par le roy en ses
requestes.N.	requestes . N .
Gaignart.	Gaignart .
