Charles,etc..Savoirfaisonsque	Charles , etc . . Savoir faisons que
,pourconsideration	, pour consideration
desbons,granset	des bons , grans et
loablesservicesquenostre	loables services que nostre
bienaméPhilippeGiliernousafaislonguementet	bien amé Philippe Gilier nous a fais longuement et
loialmenten..pluseursetdiversesmanieres	loialment en . . pluseurs et diverses manieres
,etesperons	, et esperons
queencoresplusnousfaceoutemps.avenir,nous	que encores plus nous face ou temps . avenir , nous
àycelluiavonsdonnéetoctroié,donnonsetoctroions	à ycellui avons donné et octroié , donnons et octroions
parcespresentes,degraceespecialetcertainescience..	par ces presentes , de grace especial et certaine science . .
etdenostreauctoritéroyal,àperpetuelheritage,	et de nostre auctorité royal , à perpetuel heritage ,
pour..luy,	pour . . luy ,
,pourseshoirsetles..aians	, pour ses hoirs et les . . aians
causedeluyetde	cause de luy et de
deseshoirsoutempsavenir,tous	de ses hoirs ou temps avenir , tous
lesbiensetheritagesestanzennostrechastelleniede	les biens et heritages estanz en nostre chastellenie de
Melun.et	Melun . et
ailleurs,quesouloit.	ailleurs , que souloit .
nagueresavoirettenirGuillaumede	nagueres avoir et tenir Guillaume de
Pouylly,escuier,ànousescheuzet	Pouylly , escuier , à nous escheuz et
avenusparlaforfaictureetconfiscaciondu	avenus par la forfaicture et confiscacion du
duditGuillaume,qui	du dit Guillaume , qui
poursesdemeritesaestébanni,lesquelx	pour ses demerites a esté banni , les quelx
biensetheritagespuentvaloirc.livres	biens et heritages puent valoir c . livres
parisisderenteparan	parisis de rente par an
,ouenviron	, ou environ
,sicommel	, si comme l
'endit,	' en dit ,
àyceulxbiensetheritagesavoiret	à yceulx biens et heritages avoir et
etteniretpossiderparledit	et tenir et possider par le dit
Philippe,sez..hoirs	Philippe , sez . . hoirs
hoirsetaianscauseperpetuelmentethereditairement,	hoirs et aians cause perpetuelment et hereditairement ,
commeleurpropre..chose,pour	comme leur propre . . chose , pour
vendre,despendre,aliener,	vendre , despendre , aliener ,
transporter,se	transporter , se
mestierest,etordener,àleurpropre	mestier est , et ordener , à leur propre
etpleinevolenté,touten..	et pleine volenté , tout en . .
laformeetmanierequ'il	la forme et maniere qu ' il
ilferoientetpourroientfairesec'estoit	il feroient et pourroient faire se c ' estoit
leurpropre	leur propre
heritageouconquest,par..telecondicionquele	heritage ou conquest , par . . tele condicion que le
ditPhilippe,seshoirsetaianscause,ou	dit Philippe , ses hoirs et aians cause , ou
lestenensetpossidenzyceulxles..tendront	les tenens et possidenz yceulx les . . tendront
denousetenferontfoy	de nous et en feront foy
foyethomage,enla	foy et homage , en la
manierequ	maniere qu
qu'ilappartient	qu ' il appartient
,ànousetà	, à nous et à
nozsuccesseurs,roysdeFrance	noz successeurs , roys de France
,toutesfoisquelecasyescherra,en	, toutes fois que le cas y escherra , en
paiantlesdevoirsacoustumés.Si	paiant les devoirs acoustumés . Si
mandonsparcespresentesànostrebaillideMeleun	mandons par ces presentes à nostre bailli de Meleun
etàtousnozautresjusticiersetofficiers	et à tous noz autres justiciers et officiers
,presensetavenir..	, presens et avenir . .
.,ouàleurslieuxtenans,et	. , ou à leurs lieux tenans , et
etàchascund'eulx,que	et à chascun d ' eulx , que
leditPhilippemettentenpossessionroyalmentetde	le dit Philippe mettent en possession royalment et de
defaitdesdisbiensetheritages,à.nousappartenans	de fait des dis biens et heritages , à . nous appartenans
,commeditest,etd	, comme dit est , et d
'iceulxluiet	' iceulx lui et
etseshoirs,et	et ses hoirs , et
etlesaians.causedeluiet	et les aians . cause de lui et
deseshoirs,perpetuelementethereditairementfacent,	de ses hoirs , perpetuelement et hereditairement facent ,
sueffrentetlaissentjoiretuserpaisiblement,	sueffrent et laissent joir et user paisiblement ,
senzcontreditouempeschementaucun	senz contredit ou empeschement aucun
,commeson	, comme son
propreheritage.	propre heritage .
Carainsilevoulons	Car ainsi le voulons
voulonsnous,non	voulons nous , non
obstantautresdonsou	obstant autres dons ou
gracesparnousautrefoizfaizau	graces par nous autrefoiz faiz au
ditPhilippe,queyceulxdonsougracesne	dit Philippe , que yceulx dons ou graces ne
nesoientspecifiezdemotàmot.ences	ne soient specifiez de mot à mot . en ces
cespresentes,etquelconquesordenances,mandemens,	ces presentes , et quelconques ordenances , mandemens ,
,inhibicionsetdefenses;faictesouàfaireau	, inhibicions et defenses ; faictes ou à faire au
aucontraire.Etquecesoitferme	au contraire . Et que ce soit ferme
chose,etc.Saufnostredroitenautreschoses	chose , etc . Sauf nostre droit en autres choses
,etc.Donné	, etc . Donné
auLouvre	au Louvre
lezParis	lez Paris
,l'anmil	, l ' an mil
ccclxiiii,en	ccclxiiii , en
janvier.Parleroy	janvier . Par le roy
roy,vouspresent.N	roy , vous present . N
