Philippes,parlagracedeDieu,roysde	Philippes , par la grace de Dieu , roys de
France.Savoirfaisons	France . Savoir faisons
àtouspresensetavenirque,	à tous presens et avenir que ,
commenousdenostreauctoritéroyaletpuissance	comme nous de nostre auctorité royal et puissance
,enensuiantlesfaiz	, en ensuiant les faiz
etleseuvres..	et les euvres . .
denozpredecesseurs,aiensmoutà	de noz predecesseurs , aiens mout à
cueretvueillanspourveoir	cuer et vueillans pourveoir
diligenmentqueaus..religieus	diligenment que aus . . religieus
religieusetauseglisesdenostre	religieus et aus eglises de nostre
royaume,àleurfamilleetàleursbiens	royaume , à leur famille et à leurs biens
soitpourveudeseurtédesauve	soit pourveu de seurté de sauve
protection.Pour	protection . Pour
Pourceestilquenous	Pour ce est il que nous
nouslesreligieusespersonnes,l'	nous les religieuses personnes , l '
abbéetleconventde	abbé et le convent de
de[Saint..	de [ Saint . .
-]..JouindeMarneset	-] . . Jouin de Marnes et
leurabbaieavecquestouzleursmenbres,lessingulierespersonnes	leur abbaie avecques touz leurs menbres , les singulieres personnes
deladiteabbaie	de la dite abbaie
,leurspriourtezetleurseglises,leurshomes	, leurs priourtez et leurs eglises , leurs homes
decorps	de corps
corps,leurs	corps , leurs
familiersettouzleursbiens,mettonsetprenonssouz	familiers et touz leurs biens , mettons et prenons souz
nostreprotectionetsauvegardeespecial,ès.quellessauve	nostre protection et sauve garde especial , ès . quelles sauve
gardeet	garde et
etprotectionnousvoulonsqueil	et protection nous voulons que il
demeurentperpetuelment.Mandans	demeurent perpetuelment . Mandans
MandansauseneschaldePoitouetauballid	Mandans au seneschal de Poitou et au balli d
'Anjou,etàtouznosautresjusticiers	' Anjou , et à touz nos autres justiciers
,presens	, presens
etavenir,ouàleurs	et avenir , ou à leurs
lieustenans,que	lieus tenans , que
illesdizabbéetconvent	il les diz abbé et convent
convent,tantenchief	convent , tant en chief
comeenmenbres,lezsingulierespersonnes	come en menbres , lez singulieres personnes
personnesdeladiteabbaye,leurs	personnes de la dite abbaye , leurs
priourtez,eglises,homesducors,leurs	priourtez , eglises , homes du cors , leurs
familiersettouzleurs	familiers et touz leurs
biensgardent..et	biens gardent . . et
deffendentetmaintiegnentenleur	deffendent et maintiegnent en leur
justespossessions..,libertez,us,droizet	justes possessions . . , libertez , us , droiz et
saisines,èsquellesil	saisines , ès quelles il
illeztrouverontestreetleurspredecesseurs	il lez trouveront estre et leurs predecesseurs
predecesseursavoirestépaisiblementdeancienneté,etyceulzabbéet..	predecesseurs avoir esté paisiblement de ancienneté , et yceulz abbé et . .
.convent,	. convent ,
tantenchief	tant en chief
commeen	comme en
menbres,avecleurs	menbres , avec leurs
leurspriourtezeteglises	leurs priourtez et eglises
,leurfamille,homesdessusdiz	, leur famille , homes dessus diz
dizetleursbiensgardentetdefendentet	diz et leurs biens gardent et defendent et
facentdefendredetoutesinjures,	facent defendre de toutes injures ,
,violences,oppressions,inquietacions,de	, violences , oppressions , inquietacions , de
deforced'armes,	de force d ' armes ,
,depuissance	, de puissance
delaisetdetoutesnouyeletezindeues,	de lais et de toutes nouyeletez indeues ,
,etneseuffrentcontreyceulz,leursmeisnies	, et ne seuffrent contre yceulz , leurs meisnies
,leurchoses	, leur choses
ettouzleursbiensquelconquesautreschosesindeuesestrefaites	et touz leurs biens quelconques autres choses indeues estre faites
,actentées,innovées	, actentées , innovées
innovées,maizseilleztreuventestrefaitesouactemptées	innovées , maiz se il lez treuvent estre faites ou actemptées
,silezramenentoufacent	, si lez ramenent ou facent
rameneràestatpremieretdeu,et	ramener à estat premier et deu , et
à..nousetaus	à . . nous et aus
dessusnommez,endefendantàyceulzqueil	dessus nommez , en defendant à yceulz que il
neleurmesfacent,amendersouffisanment,etnostredite	ne leur mesfacent , amender souffisanment , et nostre dite
ditesauvegardefacentpublierenleursassisesetintimer	dite sauve garde facent publier en leurs assises et intimer
àtouzceulz,..dont	à touz ceulz , . . dont
ilserontrequis.deparlezdessusnommez,en	il seront requis . de par lez dessus nommez , en
defendantàyceulzqueilleurmesfacenten	defendant à yceulz que il leur mesfacent en
enriens;	en riens ;
etdezpersonnesdequellesilleur	et dez personnes de quelles il leur
requerontà	requeront à
avoirasseurement,sileurfacentfaireetdonner	avoir asseurement , si leur facent faire et donner
loial,seloncla	loial , selonc la
coustumedupaïs.Et	coustume du païs . Et
quantaschosesdessusditesmettreplus	quant as choses dessus dites mettre plus
plusdiligemmentàexecucion,deputent	plus diligemment à execucion , deputent
ausdessusnommez,àleurcousetdespens	aus dessus nommez , à leur cous et despens
,toutesfoisqueilenserontrequisetmestier	, toutes fois que il en seront requis et mestier
sera,certains	sera , certains
gardiens,unoupluseurs,denozsergens,	gardiens , un ou pluseurs , de noz sergens ,
,souffisanspour.acomplirlezchosesdessusdites	, souffisans pour . acomplir lez choses dessus dites
,qui..facent	, qui . . facent
cequeàgardien	ce que à gardien
appartient,lezquelztoutevoiesne	appartient , lez quelz toutevoies ne
nes'entremettentdez..	ne s ' entremettent dez . .
.chosesquirequerront	. choses qui requerront
requerrontcognoissancedecause.Saufenautreschosesnostre	requerront cognoissance de cause . Sauf en autres choses nostre
droitetentoutesl'autruy.	droit et en toutes l ' autruy .
Etquecesoitfermeetestableàtouz	Et que ce soit ferme et estable à touz
joursmaiz,nousavonsfait	jours maiz , nous avons fait
mettrenostreseelencezpresenteslettres.Donné	mettre nostre seel en cez presentes lettres . Donné
àPoissi,l'andegrace	à Poissi , l ' an de grace
milccc.trenteet..	mil ccc . trente et . .
trois,oumoisde	trois , ou mois de
denovembre.Parleroy,àvostrerelacion	de novembre . Par le roy , à vostre relacion
.Savigny...	. Savigny . . .
