Loys,..par	Loys , . . par
lagracedeDieu	la grace de Dieu
roydeFrance	roy de France
.Savoir	. Savoir
faisonsàtous,	faisons à tous ,
,presens.etavenir,	, presens . et avenir ,
nousavoirreceu	nous avoir receu
l’umblesupplicaciondePerrotinHurtault	l ’ umble supplicacion de Perrotin Hurtault
Hurtault,archerdenostreordonnancesoubzlachargeet	Hurtault , archer de nostre ordonnance soubz la charge et
compagnyedenostreaméetfeal.chevalier,	compagnye de nostre amé et feal . chevalier ,
conseilleretchambellanlesirede…,contenant	conseiller et chambellan le sire de …, contenant
que,..leviie	que , . . le viie
jourdejanvierderrenierpassé,ledit	jour de janvier derrenier passé , ledit
suppliantestantlogiéenlaville	suppliant estant logié en la ville
deCharrouxenPoictou,aumoyendece	de Charroux en Poictou , au moyen de ce
qu’ilavoitestéadvertiqueung	qu ’ il avoit esté adverti que ung
nomméGiletVigieux,demouranten	nommé Gilet Vigieux , demourant en
enladictevilledeCharroux,disoitetprofferoitduditsuppliant	en ladicte ville de Charroux , disoit et profferoit dudit suppliant
plusieursparollesinjurieuses,setira	plusieurs parolles injurieuses , se tira
icelluisuppliantpardeversleditGiletetluydemandapour	icellui suppliant par devers ledit Gilet et luy demanda pour
quellecauseildisoitainsimaldeluy	quelle cause il disoit ainsi mal de luy
.Aquoyledit	. A quoy ledit
Giletresponditquedecen’estoitriens,	Gilet respondit que de ce n ’ estoit riens ,
sansautrement..excuser,ledit	sans autrement . . excuser , ledit
suppliantveant	suppliant veant
l’oultrageduditGiletse	l ’ oultrage dudit Gilet se
tenir.Orestavenu	tenir . Or est avenu
que,troissepmaines	que , trois sepmaines
ouenvironaprèsetainsiqueleditsuppliantvenoit	ou environ après et ainsi que ledit suppliant venoit
desoupperd’avecaucuns..sescompaignons,	de soupper d ’ avec aucuns . . ses compaignons ,
,ets’en	, et s ’ en
enaloientàsonlogiz,environhuit	en aloient à son logiz , environ huit
ouneufheuresdenuyt,	ou neuf heures de nuyt ,
,rancontraleditGilet,	, rancontra ledit Gilet ,
,nonsachant..quecefustil	, non sachant . . que ce fust il
il,etdemandaleditsuppliant	il , et demanda ledit suppliant
quiestcelà,etleditGiletneluy	qui est ce là , et ledit Gilet ne luy
responditriens;etalorsleditsuppliantenmarchants	respondit riens ; et alors ledit suppliant en marchant s
’aprochaduditGiletetdemendaencores	’ aprocha dudit Gilet et demenda encores
quiestcelà;et.incontinant	qui est ce là ; et . incontinant
incontinantqueleditsuppliantfutprèsduditGilet,icelluy	incontinant que ledit suppliant fut près dudit Gilet , icelluy
Gilet,.quitenoiten	Gilet , . qui tenoit en
ensamainunggrozbaston,donnaduditbastonaudit	en sa main ung groz baston , donna dudit baston audit
suppliantungsigrant	suppliant ung si grant
grantcoupsur	grant coup sur
surlajouequ’illuyrompitdeux	sur la joue qu ’ il luy rompit deux
dansenla	dans en la
boucheetlefisttumberà	bouche et le fist tumber à
àterre.Etincontinant	à terre . Et incontinant
incontinantqueleditsuppliantse	incontinant que ledit suppliant se
sesentitainsifrapé	se sentit ainsi frapé
,dedouleurqu’ilsentoit	, de douleur qu ’ il sentoit
etdesplaisancede	et desplaisance de
l.’oultrage	l . ’ oultrage
duditGilet,selevadiligemmentettirasa	dudit Gilet , se leva diligemment et tira sa
dagueetendonnaauditGilettroisouquatrecoups	dague et en donna audit Gilet trois ou quatre coups
coups,aumoiendesquelz,aprèsceque	coups , au moien desquelz , après ce que
leditGilet	ledit Gilet
aestécertaineespacedetempsmaladeet	a esté certaine espace de temps malade et
declairéetconfessé	declairé et confessé
qu’ilavoitabatu	qu ’ il avoit abatu
leditsuppliantetque,	ledit suppliant et que ,
ducoupqu	du coup qu
qu’illuy	qu ’ il luy
avoitdonné,illecuidoitbienavoirtué	avoit donné , il le cuidoit bien avoir tué
,esticeluyGilet	, est iceluy Gilet
alédevieàtrespas...Pour	alé de vie à trespas . . . Pour
Pouroccasionduquel	Pour occasion duquel
duquelcasainsiadvenucommedit.est,leditsuppliant	duquel cas ainsi advenu comme dit . est , ledit suppliant
,..doubtantrigueur	, . . doubtant rigueur
dejustice,s..’est	de justice , s . . ’ est
absentéhorsdupays,ouqueliln’oseroit	absenté hors du pays , ouquel il n ’ oseroit
jamaisaler,converser..neretourner,	jamais aler , converser . . ne retourner ,
se.nostregraceetmisericordene	se . nostre grace et misericorde ne
neluyestoientsurceimparties,ennous	ne luy estoient sur ce imparties , en nous
humblementrequerantque,attenduqueen	humblement requerant que , attendu que en
tousautrescasilatousjoursestédebonnevie	tous autres cas il a tousjours esté de bonne vie
,fameetrenomméeet	, fame et renommée et
honnesteconversacion,etc.,aussique	honneste conversacion , etc ., aussi que
toutletempsdesavieila	tout le temps de sa vie il a
servynostretrèscherseigneuret	servy nostre très cher seigneur et
etpère,queDieuabseulle,ensesguerreset	et père , que Dieu abseulle , en ses guerres et
armées,etnous..aussi,	armées , et nous . . aussi ,
,nousluy	, nous luy
vueillonssurceimpartir	vueillons sur ce impartir
nozgraceetmisericorde.Pourceestil	noz grace et misericorde . Pour ce est il
ilquenous,ceschosesconsiderées,voulansmisericorde	il que nous , ces choses considerées , voulans misericorde
estrepreferéeàrigueur	estre preferée à rigueur
dejustice	de justice
,auditPerrotinHurtault	, audit Perrotin Hurtault
avons,etc	avons , etc
.,quicté,remisetpardonné,etc.	., quicté , remis et pardonné , etc .
..Sidonnons	. . Si donnons
enmandement,par	en mandement , par
cesdictespresentes,	cesdictes presentes ,
ànostre	à nostre
nostresennechaldePoictououàsonlieutenant,età	nostre sennechal de Poictou ou à son lieutenant , et à
tousnozautresjusticiers,etc.Et.affinque	tous noz autres justiciers , etc . Et . affin que
cesoitchoseferme	ce soit chose ferme
etestable	et estable
estable,etc.Sauf,etc.	estable , etc . Sauf , etc .
Donnéà..Tours	Donné à . . Tours
,oumois	, ou mois
demarsl’	de mars l ’
andegracemilcccc.soixantesix,et	an de grace mil cccc . soixante six , et
denostrerègnelesixiesme.Ainsisigné:Par	de nostre règne le sixiesme . Ainsi signé : Par
leroy,à	le roy , à
larelacionduConseil.Amys	la relacion du Conseil . Amys
.—Visa.Contentor.	.— Visa . Contentor .
