Cesontlinondesnobles	Ce sont li non des nobles
noblesduroyaumedeFranceetdesprelazensamble	nobles du royaume de France et des prelaz ensamble
ensamble.Poitou.L	ensamble . Poitou . L
L'evesquedePoitiers.GuillaumeLarcevesque.Huguede	L ' evesque de Poitiers . Guillaume Larcevesque . Hugue de
deVivonne.Maingotdu	de Vivonne . Maingot du
Melle..LesiredeMellou.Guy	Melle . . Le sire de Mellou . Guy
GuydeBauçay.Suprascriptispersonisfuit	Guy de Bauçay . Suprascriptis personis fuit
fuitscriptumsubformisetmodis	fuit scriptum sub formis et modis
modisquisequntur	modis qui sequntur
,supereoquodtenerentse	, super eo quod tenerent se
munitosinequisetarmis	munitos in equis et armis
,elapsamediaquadragesimahujusannidecimiseptimi......Nous	, elapsa media quadragesima hujus anni decimi septimi ...... Nous
Nous.leurmandons	Nous . leur mandons
queilsetiegnentsigarnizde.chevauset	que il se tiegnent si garniz de . chevaus et
d'armesetautrement.,seloncl	d ' armes et autrement . , selonc l
'estatet.	' estat et .
lacondicionde	la condicion de
dechascun,que	de chascun , que
ildèsoresen.avant	il dès ores en . avant
,meesmementpuislamikaresmeenlà,	, meesmement puis la mi karesme en là ,
nouslespuissiensavoirsenznullefauteprezetappareilliez	nous les puissiens avoir senz nulle faute prez et appareilliez
denoussuir	de nous suir
etd'alerlàounouslesvoudronsmener	et d ' aler là ou nous les voudrons mener
menerouenvoier...Donné	mener ou envoier ... Donné
àLorrizenGastinois,lexvejourdenovembre	à Lorriz en Gastinois , le xve jour de novembre
novembrel'andegracem.ccc.	novembre l ' an de grace m . ccc .
