Charles,..parlagracedeDieu	Charles , . . par la grace de Dieu
DieuroydeFrance.Savoirfaisons	Dieu roy de France . Savoir faisons
faisonsàtous,presensetavenir,que	faisons à tous , presens et avenir , que
,commepar.l'accortettraitié	, comme par . l ' accort et traitié
naguerresfais.parnostretrèschierettrèsamé	naguerres fais . par nostre très chier et très amé
frere,leducdeBerry.etd'Auvergne	frere , le duc de Berry . et d ' Auvergne
,contedePoitiers,deXaintongeet	, conte de Poitiers , de Xaintonge et
d'Angolesme,nostrelieutenantèsdis	d ' Angolesme , nostre lieutenant ès dis
païs,etnostretrès	païs , et nostre très
trèschierettrèsamé	très chier et très amé
amé.frere,le	amé . frere , le
ducdeBourgongne,nostreamé	duc de Bourgongne , nostre amé
etfealconnestable	et feal connestable
,BertranduGuesclin	, Bertran du Guesclin
Guesclin,duc.deMouline,et	Guesclin , duc . de Mouline , et
etnostreaméetfealcousin,lesirede	et nostre amé et feal cousin , le sire de
deCliçon,	de Cliçon ,
avecpluseursprelas,	avec pluseurs prelas ,
gensd'église	gens d ' église
,barons,seigneurs,	, barons , seigneurs ,
,damesetautresdesdis	, dames et autres des dis
païs.dePoitouetdeXantonge	païs . de Poitou et de Xantonge
,poureulx,pour	, pour eulx , pour
leursalliés,subgésetleursterres,lesquelz	leurs alliés , subgés et leurs terres , les quelz
prelas,gensd	prelas , gens d
'église	' église
église,barons,seigneurs	église , barons , seigneurs
seigneursetdames,etautresdessusdis	seigneurs et dames , et autres dessus dis
parlesdis	par les dis
traitiéetaccort	traitié et accort
sont.retournéset	sont . retournés et
venusdenouvelennostreobeissanceetsubjection	venus de nouvel en nostre obeissance et subjection
,etsoubzycellesontmis	, et soubz ycelles ont mis
etrendusleursvilles	et rendus leurs villes
,chasteaux,forteresces	, chasteaux , forteresces
forteresces,leurssubgiés	forteresces , leurs subgiés
etleursterres,	et leurs terres ,
etveulentetontpromisetaccordédemourerà	et veulent et ont promis et accordé demourer à
tousjoursmais,nosdiz	tousjours mais , nos diz
freres,.connestableetsiredeCliçonleur	freres , . connestable et sire de Cliçon leur
aientaccordéetoctroié,pournousetennostre	aient accordé et octroié , pour nous et en nostre
nostre.nom,pluseurs	nostre . nom , pluseurs
poinsetarticlesciaprèscontenus.etdeclarés	poins et articles ci après contenus . et declarés
declarés;nous,consideransletrèsgrantetbonne	declarés ; nous , considerans le très grant et bonne
affectionet	affection et
volentéqueyceulxprelas,gensd'eglise	volenté que yceulx prelas , gens d ' eglise
,barons,seigneursetautresdessusdiznous	, barons , seigneurs et autres dessus diz nous
ontencemonstré	ont en ce monstré
etmonstrent,etaussi	et monstrent , et aussi
enratifiant,	en ratifiant ,
approvantetconfermantlesdisaccortettraitié	approvant et confermant les dis accort et traitié
traitiéfaisaveceulxparnosdisfrères..,	traitié fais avec eulx par nos dis frères . . ,
,connestableetsiredeCliçondessusdis,yceulxpoins	, connestable et sire de Cliçon dessus dis , yceulx poins
etarticles.avons,denostre	et articles . avons , de nostre
certainescience,	certaine science ,
auctoritéetpuissanceroyal,accordésetoctroiésausdis	auctorité et puissance royal , accordés et octroiés aus dis
prelas,gensd'	prelas , gens d '
église,	église ,
,barons,seigneurs,damesetautresdessusdiz	, barons , seigneurs , dames et autres dessus diz
,poureulx,	, pour eulx ,
leurssubgiés	leurs subgiés
,adherens,alliezetleursterres,etles	, adherens , alliez et leurs terres , et les
les.habitansdes	les . habitans des
desdizpays	des diz pays
,et,par	, et , par
parlateneurdeces	par la teneur de ces
presentes,les	presentes , les
leursaccordonsetoctroions,	leurs accordons et octroions ,
enlafourmeetmaniere	en la fourme et maniere
qui.s'ensuivent	qui . s ' ensuivent
ensuivent:1	ensuivent : 1
.C'estassavoir	. C ' est assavoir
quelesdisprelas,gensd'eglise,	que les dis prelas , gens d ' eglise ,
,barons,	, barons ,
seigneurs,damesetautresdessusdiz	seigneurs , dames et autres dessus diz
dizdesdispaïsde	diz des dis païs de
PoitouetdeXantonge,quisontvenusetretournés	Poitou et de Xantonge , qui sont venus et retournés
retournésennostreobeissance,commeditest,.	retournés en nostre obeissance , comme dit est , .
.etleurshoirset	. et leurs hoirs et
successeursouaianscaused'eulz,leurs	successeurs ou aians cause d ' eulz , leurs
leursvilles,chasteaus,forteresces,terres,payset	leurs villes , chasteaus , forteresces , terres , pays et
subgés..seront	subgés . . seront
etdemourontdoresenavantetperpetuelmentannexés	et demouront doresenavant et perpetuelment annexés
,unisetadjoinsànous	, unis et adjoins à nous
nous,àlacouronne	nous , à la couronne
deFrance,ouànostreditfrere,le	de France , ou à nostre dit frere , le
leducdeBerry,conte	le duc de Berry , conte
contedesditescontés,.ouàses	conte des dites contés , . ou à ses
enfans,sanscequeparnous	enfans , sans ce que par nous
nousoueulx..,oules	nous ou eulx . . , ou les
successeursdenousou.d'eulz	successeurs de nous ou . d ' eulz
,ilpuissentestremis	, il puissent estre mis
,bailliés,	, bailliés ,
,alienésoutransportésenautresmainsou	, alienés ou transportés en autres mains ou
enautresobeissanceousubjection	en autres obeissance ou subjection
dequelconquesautrespersonnes,quelles	de quelconques autres personnes , quelles
queellessoient,pourquelconquescausesouoccasion	que elles soient , pour quelconques causes ou occasion
,neenquelconquemanierequece	, ne en quelconque maniere que ce
soit.2.Item,et	soit . 2 . Item , et
etpource	et pour ce
[que]outempsdela	[ que ] ou temps de la
guerrequi..aestéetencores	guerre qui . . a esté et encores
estentrenousetnostreadversaired'Angleterre	est entre nous et nostre adversaire d ' Angleterre
,parlesdessusdisprelas,barons,	, par les dessus dis prelas , barons ,
seigneurs,dameset	seigneurs , dames et
autresdessusdiz.et	autres dessus diz . et
leurssubgiezetalliez,et	leurs subgiez et alliez , et
habitansdesdis	habitans des dis
pays,les	pays , les
quelzonttenu.le	quelz ont tenu . le
partidenostredit	parti de nostre dit
adversaireèspaïs	adversaire ès païs
dessusdis,pour..ce	dessus dis , pour . . ce
queparletraitié.	que par le traitié .
.pieçafaitentrefeunostre	. pieça fait entre feu nostre
trèschier	très chier
chierseigneuret	chier seigneur et
pere,queDieu	pere , que Dieu
absoille,	absoille ,
,etleroyd'Angleterre	, et le roy d ' Angleterre
Angleterre,lespaïsdessusdizavoientestébailliés	Angleterre , les païs dessus diz avoient esté bailliés
etdelivrésau..ditroyd'	et delivrés au . . dit roy d '
Angleterreetestoientlesdessusdisdevenusses	Angleterre et estoient les dessus dis devenus ses
hommeset	hommes et
subgiez,ouduprincedeGalessonfilz,	subgiez , ou du prince de Gales son filz ,
auquelilavoitdonné..lesdizpaïs,	au quel il avoit donné . . les diz païs ,
peventavoiresté	pevent avoir esté
parlefaitdeladicte..guerreouautrement	par le fait de la dicte . . guerre ou autrement
,outempspassé	, ou temps passé
,commispluseursdesobeissancesetrebellions	, commis pluseurs desobeissances et rebellions
,etpluseurs..crimes	, et pluseurs . . crimes
enpluseursmanieresenversnous;nous,pourconsideraciondes	en pluseurs manieres enversnous ; nous , pour consideracion des
chosesdessusdictes,	choses dessus dictes ,
avonsausdessusdizprelas	avons aus dessus diz prelas
,gensd'eglise,barons	, gens d ' eglise , barons
,seigneurs,damesetautres	, seigneurs , dames et autres
dessusdiz,	dessus diz ,
,etàtous	, et à tous
leurssubgiez,alliezet	leurs subgiez , alliez et
adherens,ethabitans	adherens , et habitans
duditpays,	du dit pays ,
,quisontretournésetvenusennostredicteobeissance	, qui sont retournés et venus en nostre dicte obeissance
etsubjection,comme	et subjection , comme
ditest,etchascund	dit est , et chascun d
'eulz,quittié..,remisetpardonné,	' eulz , quittié . . , remis et pardonné ,
et,parla	et , par la
teneurde..ces	teneur de . . ces
presentes,denostre	presentes , de nostre
nostreplainepuissanceetauctoritéroyal,de	nostre plaine puissance et auctorité royal , de
nostrecertaine	nostre certaine
scienceetdegraceespecial	science et de grace especial
,leurquittons,remettonsetpardonnonstoutes	, leur quittons , remettons et pardonnons toutes
lesdictesrebellionsetdesobeissances	les dictes rebellions et desobeissances
,.seaucunes	, . se aucunes
aucunesenontfaites,ettouslescrimes,delis	aucunes en ont faites , et tous les crimes , delis
delis,excèsetmalefices..pareulz	delis , excès et malefices . . par eulz
ouaucunsd'eulz,	ou aucuns d ' eulz ,
s'aucuns	s ' aucuns
enontcommisetperpetrés,	en ont commis et perpetrés ,
durantlaguerredessus	durant la guerre dessus
dessusdicteouautrement,enquelque	dessus dicte ou autrement , en quelque
manierequecesoit,	maniere que ce soit ,
avectoutepeine	avec toute peine
peine,amendeetoffensécorporele	peine , amende et offensé corporele
corporele,crimineleetcivilequeilpeventavoirencouruenvers	corporele , criminele et civile que il pevent avoir encouru envers
nousounostreditfrere,contedesdis	nous ou nostre dit frere , conte des dis
païs,pourcausedescrimes,delis,	païs , pour cause des crimes , delis ,
excèsetmaleficesdessusdis,	excès et malefices dessus dis ,
seaucunsenontcommis,pourle	se aucuns en ont commis , pour le
faitdela	fait de la
laditeguerre	la dite guerre
guerreouautrement,	guerre ou autrement ,
,commeditest,soientcrimedelesemajesté,	, comme dit est , soient crime de lese majesté ,
,murtres,ravisemenset	, murtres , ravisemens et
violemensdefemmes	violemens de femmes
,..sacrileges	, . . sacrileges
,larrecins	, larrecins
,pilleries,roberies,arsins,rançonnemens	, pilleries , roberies , arsins , rançonnemens
ouautresquelconques,commentque	ou autres quelconques , comment que
ilsoientnommés	il soient nommés
,jàsoit	, jà soit
cequeilnesoientmiedeclarés..,specifiés	ce que il ne soient mie declarés . . , specifiés
ouexprimésencespresentes;etlesrestituons	ou exprimés en ces presentes ; et les restituons
etchascund'eulzà	et chascun d ' eulz à
àleursbonnesrenommées,leurspayset	à leurs bonnes renommées , leurs pays et
àleursbiens	à leurs biens
biens,nonobstansquelconquesdons	biens , non obstans quelconques dons
quenousou	que nous ou
nozlieuxtenansenaionsfais.Etsurceimposons	noz lieuxtenans en aions fais . Et sur ce imposons
imposonssilenceperpetuel.àtousnozjusticiers	imposons silence perpetuel . à tous noz justiciers
,procureurs,officierset	, procureurs , officiers et
etàtousautres,etvoulonsqueil	et à tous autres , et voulons que il
ilendemeurentquittes,.delivrésetpaisiblesenvers	il en demeurent quittes , . delivrés et paisibles envers
nous,nostreditfrereleducdeBerry	nous , nostre dit frere le duc de Berry
Berry,contedes	Berry , conte des
ditescontés,etàtousautres	dites contés , et à tous autres
quiaucunechoseleurenvouroientoupourroientdemander,	qui aucune chose leur en vouroient ou pourroient demander ,
sanscequeilenpuissentjamais	sans ce que il en puissent jamais
estreapprochiés,inquietés,molestésetempeschiésenaucune	estre approchiés , inquietés , molestés et empeschiés en aucune
maniere.3	maniere . 3
.Item,voulons..etleuroctroionsquetoutesles	. Item , voulons . . et leur octroions que toutes les
villes,chasteaux,	villes , chasteaux ,
,forterescesetautrespossesssions,heritages	, forteresces et autres possesssions , heritages
,terresetbiensimmeubles,quelz	, terres et biens immeubles , quelz
quelzqueil	quelz que il
soient,estansennostreroyaumeetennostrepooir	soient , estans en nostre royaume et en nostre pooir
etdenossubgiezetalliés	et de nos subgiez et alliés
,oud'aucunsd'eulx,	, ou d ' aucuns d ' eulx ,
,quijadisfurentausdisprelas	, qui jadis furent aus dis prelas
prelas,gensd'eglise,barons,seigneurs,	prelas , gens d ' eglise , barons , seigneurs ,
damesetautresdessusdiz,deleurssubgiez	dames et autres dessus diz , de leurs subgiez
,alliés	, alliés
ethabitansdesdispays,etdeleurs	et habitans des dis pays , et de leurs
leurspredecesseursoùd'aucund'	leurs predecesseurs où d ' aucun d '
eulx,qui	eulx , qui
pourl'occasion	pour l ' occasion
occasionetsoubzl..'ombre	occasion et soubz l . . ' ombre
deladiteguerreontestédonnéesoutransportées	de la dite guerre ont esté données ou transportées
parnous,noz	par nous , noz
disfreres,noslieuxtenans	dis freres , nos lieux tenans
,nostreditconnestable,nosmareschausouautres	, nostre dit connestable , nos mareschaus ou autres
autresquelconques,pourquelconquecause	autres quelconques , pour quelconque cause
etparquelquespersonnesqueellessoientempeschiées	et par quelques personnes que elles soient empeschiées
,soientetseront	, soient et seront
misesaudelivreaus	mises au delivre aus
prelas,barons	prelas , barons
,seigneurs..,	, seigneurs . . ,
damesetautresdessusdis,etalliés	dames et autres dessus dis , et alliés
etsubgiez,etàchascund'eulz,	et subgiez , et à chascun d ' eulz ,
,pourtant	, pour tant
tantcommeillui	tant comme il lui
puettouchier,et	puet touchier , et
leurserontbailliées,renduesetrestituéesentelle	leur seront bailliées , rendues et restituées en telle
manierequeilenpuissentjoiretycellespossideret	maniere que il en puissent joir et ycelles possider et
exploitieràplain	exploitier à plain
plain.etau	plain . et au
délivre,sicommeeulx..	délivre , si comme eulx . .
etleurspredecesseursenont	et leurs predecesseurs en ont
ontacoustuméàjoiretqu'il	ont acoustumé à joir et qu ' il
enjoissoientparavantlesdisempeschemens,en	en joissoient paravant les dis empeschemens , en
ostantyceulxempeschemensmis	ostant yceulx empeschemens mis
par..quelquepersonneet	par . . quelque personne et
pourquelconquecauseque	pour quelconque cause que
cesoit;parmice	ce soit ; parmi ce
toutevoisquepareillement	toutevois que pareillement
touteslesvilles,	toutes les villes ,
chasteausetautres.terres,possessions,heritageset	chasteaus et autres . terres , possessions , heritages et
etbiensquelconquesimmeubles,quelz	et biens quelconques immeubles , quelz
queilsoient,appartenans	que il soient , appartenans
ou[qui]	ou [ qui ]
jadisfurentàaucunsprelas,gensd'	jadis furent à aucuns prelas , gens d '
'eglise,barons,seigneurs,dames,nobles,	' eglise , barons , seigneurs , dames , nobles ,
bourgoisouautresnozsubgiez,quiont	bourgois ou autres noz subgiez , qui ont
onttenunostreparti,oude	ont tenu nostre parti , ou de
leurspredecesseurs,ou	leurs predecesseurs , ou
d'.aucuns	d ' . aucuns
aucunsd'eulx,estansetseansés	aucuns d ' eulx , estans et seans és
dispaïsdePoitouetXantongeetoupaysde	dis païs de Poitou et Xantonge et ou pays de
Guienne,aupooirde	Guienne , au pooir de
denostreditadversaireoudesonditfilz	de nostre dit adversaire ou de son dit filz
filz,quipareulxouleurs	filz , qui par eulx ou leurs
enfans,oulieuxtenans,connestable,mareschaux	enfans , ou lieux tenans , connestable , mareschaux
ouofficiersquelconques,ou	ou officiers quelconques , ou
parquelconquesautresesté	par quelconques autres esté
donnés.outransportés,pouroccasionetsoubzumbre	donnés . ou transportés , pour occasion et soubz umbre
umbredeladicteguerre,àquelconquepersonneetpour	umbre de la dicte guerre , à quelconque personne et pour
pourquelconquecausequecesoit,	pour quelconque cause que ce soit ,
ausdisprelas.	aus dis prelas .
.,gensd'église,barons	. , gens d ' église , barons
,seigneurs,damesetautreshabitansdez	, seigneurs , dames et autres habitans dez
païsdessusdiz,àleursalliésousubgiés,	païs dessus diz , à leurs alliés ou subgiés ,
ouàaucuns	ou à aucuns
d'eulzserontrendus,restitués	d ' eulz seront rendus , restitués
restituésetdelivrezànoz	restitués et delivrez à noz
nozdissubgiés..,	noz dis subgiés . . ,
àquiycelles	à qui ycelles
ycellesvilles,forteresces,terres,possessions,	ycelles villes , forteresces , terres , possessions ,
heritagesetbiens	heritages et biens
inmeublesfurentetappartindrent,ouà	inmeubles furent et appartindrent , ou à
leurspredecesseurs,comme	leurs predecesseurs , comme
ditest,etleurenserontles	dit est , et leur en seront les
disempeschemensmisparquelquepersonneoupour..quelconque	dis empeschemens mis par quelque personne ou pour . . quelconque
causequecesoit,osté,	cause que ce soit , osté ,
etpourenjoir	et pour en joir
joiretexploiter	joir et exploiter
exploiteràplainetaudelivre,enla	exploiter à plain et au delivre , en la
lamanierequeeulxetleurspredecesseursenjoissoientet	la maniere que eulx et leurs predecesseurs en joissoient et
etusoientavant	et usoient avant
avantlesempeschemensdessusdis...	avant les empeschemens dessus dis . . .
4.Item,se	4 . Item , se
seaucunsdesparensdesdis	se aucuns des parens des dis
prelas,gensd'eglise,barons	prelas , gens d ' eglise , barons
,seigneurs,damesetautres	, seigneurs , dames et autres
dessusdis,oudeleurssubgiéset	dessus dis , ou de leurs subgiés et
et.alliéssontalésde	et . alliés sont alés de
vieàtrespassementduranslesdictesguerresouparavant,	vie à trespassement durans les dictes guerres ou paravant ,
,les..biensdes	, les . . biens des
quelztrespassezassisouasseansennostre	quelz trespassez assis ou asseans en nostre
royaumeouailleurs,ennostrepooiroudenostre	royaume ou ailleurs , en nostre pooir ou de nostre
ditfrere	dit frere
,leducde	, le duc de
Berry,appartenansausdisprelas,gensd	Berry , appartenans aus dis prelas , gens d
'eglise,barons,seigneurs,damesetautres	' eglise , barons , seigneurs , dames et autres
autresdessusdis,ouleurssubgiésoualliés	autres dessus dis , ou leurs subgiés ou alliés
,àaucuns	, à aucuns
d'eulxparlasuccessiondesdisdefuns,	d ' eulx par la succession des dis defuns ,
,ouautrement,lesquelz	, ou autrement , les quelz
biensontou..	biens ont ou . .
pooientavoirestédonnésparnous	pooient avoir esté donnés par nous
ouparnozdiz	ou par noz diz
freres,	freres ,
connestableetsiredeCliçon,commenostrelieu	connestable et sire de Cliçon , comme nostre lieu
tenant,ouaucund'	tenant , ou aucun d '
eulx,ou	eulx , ou
parautres,ouautrement	par autres , ou autrement
empeschiés,entellemaniere	empeschiés , en telle maniere
queyceulxprelas	que yceulx prelas
,gensd'eglise,barons..,seigneurs,	, gens d ' eglise , barons . . , seigneurs ,
damesetautresdessusdis,leurssubgiéset	dames et autres dessus dis , leurs subgiés et
alliés,ouaucunsd'eulz,	alliés , ou aucuns d ' eulz ,
n'enpeventouontpeujoir,	n ' en pevent ou ont peu joir ,
lesdizempeschemens	les diz empeschemens
empeschemens.,quantennousestouànous	empeschemens . , quant en nous est ou à nous
nouspuetappartenir	nous puet appartenir
,etquant	, et quant
à..ceulxquiontcause	à . . ceulx qui ont cause
causedenous,	cause de nous ,
denosdis	de nos dis
disfreres,connestable,siredeCliçonoude	dis freres , connestable , sire de Cliçon ou de
nozlieuxtenansouofficiersquelconques	noz lieux tenans ou officiers quelconques
quelconques,leursseront	quelconques , leurs seront
ostésrealmentetde	ostés realment et de
defait,	de fait ,
etlesdisbiensdelivrés	et les dis biens delivrés
delivréspartelle	delivrés par telle
manierequelesdisprelas,gensd'	maniere que les dis prelas , gens d '
'eglise,barons,	' eglise , barons ,
seigneurs,dames	seigneurs , dames
etautresdessusdis,etleursdis	et autres dessus dis , et leurs dis
subgiezetalliés,etchascund'	subgiez et alliés , et chascun d '
'eulx,pourtantcommeillipuettouchieretappartenir	' eulx , pour tant comme illi puet touchier et appartenir
,enporrontjoiryceulxetpossideretexploitier	, en porront joir yceulx et possider et exploitier
delivreement,partellemaniereque	delivreement , par telle maniere que
queles..distrespassésenjoissoientoudevoient	que les . . dis trespassés en joissoient ou devoient
joir,ou	joir , ou
tempsdeleurtrespassementetparavant.Etaussi	temps de leur trespassement et par avant . Et aussi
samblablementserafait,deleurcosté,desbiens.	samblablement sera fait , de leur costé , des biens .
desparansd'aucunsdenossubgiés,	des parans d ' aucuns de nos subgiés ,
adherensetalliés,quiparnostre	adherens et alliés , qui par nostre
ditadversaired'Angleterre,ses	dit adversaire d ' Angleterre , ses
enfans,lieutenansouofficiersquelconques,auroient	enfans , lieutenans ou officiers quelconques , auroient
estédonnésausprelas,gensd'eglise,	esté donnés aus prelas , gens d ' eglise ,
barons,seigneurs,damesetautresdessus	barons , seigneurs , dames et autres dessus
dis,ouà	dis , ou à
leurssubgiezetalliés,ouàaucunsd'.	leurs subgiez et alliés , ou à aucuns d ' .
..eulz,commedessusestdit.5	. . eulz , comme dessus est dit . 5
.Item.,voulonset	. Item . , voulons et
leuravonsoctroiéetoctroionsparcespresentesquetous	leur avons octroié et octroions par ces presentes que tous
lesdonsetoctroisdesimposicions,guiesoutailles	les dons et octrois des imposicions , guies ou tailles
faisausdisprelas,barons,seigneurs,dames	fais aus dis prelas , barons , seigneurs , dames
damesetautresdessusnommés,ouaucunsd'eulx	dames et autres dessus nommés , ou aucuns d ' eulx
parnostre..ditadversaired'	par nostre . . dit adversaire d '
'Angleterre,sesdisenfansoulieus	' Angleterre , ses dis enfans ou lieus
tenans,ouaucunsd	tenans , ou aucuns d
'eulx,pourlesreparacions,	' eulx , pour les reparacions ,
,gardesoufortificacionsdeleurschasteausouforteresces	, gardes ou fortificacions de leurs chasteaus ou forteresces
,vaudront,tendrontetaurontleurplain	, vaudront , tendront et auront leur plain
effect..parletempsetjusquesen	effect . . par le temps et jusques en
lafindutermedel'octroyoudon	la fin du terme de l ' octroy ou don
denostreditadversaire,sesenfansoulieustenans,	de nostre dit adversaire , ses enfans ou lieustenans ,
seilnepassentoultrecinqans	se il ne passent oultre cinq ans
avenir,ouquelcasilvaudront.ettendront,	avenir , ou quel cas il vaudront . et tendront ,
etles..aurontjusquesaudit	et les . . auront jusques au dit
termedecinq	terme de cinq
ansprochainsavenir,àcompterdeladate	ans prochains avenir , à compter de la date
decespresentes	de ces presentes
presentes,etansdedens,seàmainsdetemps	presentes , et ans dedens , se à mains de temps
tempsfurentoctroiées.6.Item,	temps furent octroiées . 6 . Item ,
voulonsetavonsoctroie.et	voulons et avons octroie . et
etoctroionsausdisprelas,gensd	et octroions aus dis prelas , gens d
'eglise,barons,	' eglise , barons ,
,seigneursetdamesetautresdessusdis	, seigneurs et dames et autres dessus dis
etleurssubgiezetalliés,que	et leurs subgiez et alliés , que
ilserontetsontquittesetdelivrésde.tousles	il seront et sont quittes et delivrés de . tous les
fruisetlevéesqueil	fruis et levées que il
onteus,levezetreceusoutemps	ont eus , levez et receus ou temps
tempspassédesterres,possessions,heritageset	temps passé des terres , possessions , heritages et
chosesà..eulx	choses à . . eulx
données,commeditest,	données , comme dit est ,
sansceque	sans ce que
aucunleuren	aucun leur en
puisseriensdemander.7.Item,etne	puisse riens demander . 7 . Item , et ne
serontles..disprelas,gensd	seront les . . dis prelas , gens d
'eglise,barons,seigneurs,dameset	' eglise , barons , seigneurs , dames et
etautresdessusdis,leurssubgiésetalliés,	et autres dessus dis , leurs subgiés et alliés ,
ouaucunsd'eulz,tenus	ou aucuns d ' eulz , tenus
tenusnecontrainsàdelaissier	tenus ne contrains à delaissier
delaissieroudelivrerlesterresetchosesqu..	delaissier ou delivrer les terres et choses qu . .
.'ilont	. ' il ont
ettiennentpourcause..	et tiennent pour cause . .
.desdonsdessusdis,enquelquepays,pooir	. des dons dessus dis , en quelque pays , pooir
oujurisdicion	ou jurisdicion
qu'ilsoient,jusquesàtantqueil	qu ' il soient , jusques à tant que il
ilaientleurschastiaux,villesetautresbiens..	il aient leurs chastiaux , villes et autres biens . .
seansetestansennostrepooir	seans et estans en nostre pooir
pooiretjurisdicion,ouaupooirde	pooir et jurisdicion , ou au pooir de
denostreditfrerede	de nostre dit frere de
Berryoudenossubgiés	Berry ou de nos subgiés
subgiésetalliez,etseaucunempeschementleurestoit	subgiés et alliez , et se aucun empeschement leur estoit
mis,queilleursoitosté	mis , que il leur soit osté
etmisaudelivre.8.Item	et mis au delivre . 8 . Item
,etquesa	, et que sa
aucunsdonsetoctroisontestéfaispar	aucuns dons et octrois ont esté fais par
nous,parnosdisfreres,connestable	nous , par nos dis freres , connestable
,lieustenansoumareschaus,	, lieustenans ou mareschaus ,
oul'und'eulx,	ou l ' un d ' eulx ,
ouautres,d'aucunsdes	ou autres , d ' aucuns des
desbiensdes	des biens des
disprelas,gens	dis prelas , gens
d'eglise,barons,	d ' eglise , barons ,
,seigneurs,damesetautresdessus	, seigneurs , dames et autres dessus
dis,deleurssubgiéset..alliés	dis , de leurs subgiés et . . alliés
alliés,ouseilontestépriset	alliés , ou se il ont esté pris et
misennostremain,pourcausedeladicte	mis en nostre main , pour cause de la dicte
rebellionouautrement,	rebellion ou autrement ,
depuis.latrieveousoufrancequiparnosdis	depuis . la trieve ou soufrance qui par nos dis
freres,connestableetsire..deCliçon,comme	freres , connestable et sire . . de Cliçon , comme
nostrelieutenant,ouaucunsd'eulx,	nostre lieutenant , ou aucuns d ' eulx ,
,fuaccordéeet	, fu accordée et
donnéeàLodunouailleurs	donnée à Lodun ou ailleurs
ailleurs,nousvoulons..etleur	ailleurs , nous voulons . . et leur
leuroctroionsqueilsoientnulzetdenul	leur octroions que il soient nulz et de nul
effect,etquelespossidensd'iceulzseront	effect , et que les possidens d ' iceulz seront
contrainsparnousounostreditfrere,le	contrains par nous ou nostre dit frere , le
ducdeBerry,..	duc de Berry , . .
contedesdispaïs,ounosofficiers	conte des dis païs , ou nos officiers
officiers,à	officiers , à
yceulxbiensbailleretdelivreràceulx	yceulx biens bailler et delivrer à ceulx
àquiilappartenoient	à qui il appartenoient
appartenoientoutemps	appartenoient ou temps
tempsetpar..	temps et par . .
.avantlesdisdons,	. avant les dis dons ,
,afinquedesdisbiensdonnésil	, afin que des dis biens donnés il
ilpuissentjoiràplainetau.delivre;etseront	il puissent joir à plain et au . delivre ; et seront
ceulxquiaucunechoseenontprisoulevé	ceulx qui aucune chose en ont pris ou levé
contrainsàleurrendreetrestituer.9	contrains à leur rendre et restituer . 9
.Item,etseilavenoitqueguerre.	. Item , et se il avenoit que guerre .
.fustmeueèsdispays	. fust meue ès dis pays
dePoitouetdeXantongeparnostreditadversaire	de Poitou et de Xantonge par nostre dit adversaire
adversaire,sesenfansouaucunsdeleurspaïs	adversaire , ses enfans ou aucuns de leurs païs
,oud'autresleurssubgiezetalliés	, ou d ' autres leurs subgiez et alliés
qui,ounomd'	qui , ou nom d '
'eulx,porroientfaireguerreausdis	' eulx , porroient faire guerre aus dis
prelas,gensd'eglise,barons,	prelas , gens d ' eglise , barons ,
seigneurs,.damesetautres	seigneurs , . dames et autres
autresdessusdis,leurssubgiésetalliés,ouaucuns	autres dessus dis , leurs subgiés et alliés , ou aucuns
aucunsd'eulx,nous	aucuns d ' eulx , nous
etnostreditfreredeBerry	et nostre dit frere de Berry
lesgarderonsetdefendrons,	les garderons et defendrons ,
,sicommenousferonsetsommestenusdegarder	, si comme nous ferons et sommes tenus de garder
garderetdefendrenosautressubgiez.10	garder et defendre nos autres subgiez . 10
10.Item,etseilavenoit	10 . Item , et se il avenoit
avenoitque.lesdisprelas,gensd'eglise	avenoit que . les dis prelas , gens d ' eglise
eglise,barons	eglise , barons
barons,seigneurs,damesetautresdessusdis	barons , seigneurs , dames et autres dessus dis
perdissentpourladicteguerreaucunsdeleurs	perdissent pour la dicte guerre aucuns de leurs
chastiaus,villes,forteresces,	chastiaus , villes , forteresces ,
terreoupays,nousetnostreditfrere	terre ou pays , nous et nostre dit frere
freredeBerrylesayderons,si	frere de Berry les ayderons , si
commenousferionsnosautressubgiez...	comme nous ferions nos autres subgiez . . .
.11.Item,voulonsetoctroions	. 11 . Item , voulons et octroions
octroionsquelesdisprelas,gensd'eglise,	octroions que les dis prelas , gens d ' eglise ,
barons,	barons ,
seigneurs,	seigneurs ,
,damesetautresdessusdiset.leurssubgiezetalliés	, dames et autres dessus dis et . leurs subgiez et alliés
soientetdemeurentquittes,deschargiésetdelivrés..,eulx	soient et demeurent quittes , deschargiés et delivrés . . , eulx
etleurshoirsetsuccesseurs	et leurs hoirs et successeurs
successeurs,ettousautresdontilseroient	successeurs , et tous autres dont il seroient
seroienttenusdeprendre.la	seroient tenus de prendre . la
defensedeleursbiens,de	defense de leurs biens , de
toutestailles	toutes tailles
,imposicions,prinsesdeblez,de	, imposicions , prinses de blez , de
de.vins,bestesetautreschoses,d'	de . vins , bestes et autres choses , d '
abusde..justicefaispareulx,ouaucunsd	abus de . . justice fais par eulx , ou aucuns d
'eulx,en	' eulx , en
leursterres	leurs terres
etpooir,etsurleurs	et pooir , et sur leurs
leurssubgiésoualliés,enquelquepaïset	leurs subgiés ou alliés , en quelque païs et
etenquelquetemps,etcontrequelconque.	et en quelque temps , et contre quelconque .
personnequecesoit,sansceque	personne que ce soit , sans ce que
quel'enleurpuissejamaisriens	que l ' en leur puisse jamais riens
riensdemanderpourletempspassé	riens demander pour le temps passé
jusquesaujourdelasaintAndrieudarreniere	jusques au jour de la saint Andrieu darreniere
darrenierepassée.	darreniere passée .
.12.Item,et	. 12 . Item , et
leuravonsoctroiéetoctroionsque,[se]depuis	leur avons octroié et octroions que ,[ se ] depuis
lesaccorsetconvenancesfaitesentrefeu	les accors et convenances faites entre feu
nostretrès	nostre très
chierseigneuret	chier seigneur et
pere,..que	pere , . . que
Dieuxabsoille,et	Dieux absoille , et
nostredit	nostre dit
adversaire,sesenfans,alliés	adversaire , ses enfans , alliés
etsubgiez,aucunsprocèsavoientestéfaiten	et subgiez , aucuns procès avoient esté fait en
lacourtdenostreparlementouen	la court de nostre parlement ou en
autresdenoscours,oudenosfreresdessus	autres de nos cours , ou de nos freres dessus
dis,parnousouaucunsdenossubgiez,	dis , par nous ou aucuns de nos subgiez ,
oudenosdisfreres	ou de nos dis freres
freresoudenoz(sic)contreles	freres ou de noz ( sic ) contre les
prelas.,gensd'eglise,barons,seigneurs	prelas . , gens d ' eglise , barons , seigneurs
,damesetautresdessusdis,oucontreleurs	, dames et autres dessus dis , ou contre leurs
leursalliésetsubgiezoulespredecesseurs	leurs alliés et subgiez ou les predecesseurs
d'eulzoud'aucunsd'	d ' eulz ou d ' aucuns d '
eulx,ousurleurs	eulx , ou sur leurs
biens,yceulxprocès..	biens , yceulx procès . .
ettoutcequis'enestensuy	et tout ce qui s ' en est ensuy
etpourroit	et pourroit
ensuir,jusquesaujourdela	ensuir , jusques au jour de la
datedecespresentes,serontmisetles	date de ces presentes , seront mis et les
mettonsauneant,etnevoulons	mettons au neant , et ne voulons
yceulxestred'aucuneffect,mais	yceulx estre d ' aucun effect , mais
voulonsetoctroionsquelesdessus	voulons et octroions que les dessus
disprelaset	dis prelas et
etgensd'..eglise,	et gens d ' . . eglise ,
barons,seigneurs,dameset	barons , seigneurs , dames et
autres,etleursubgiezetalliés,soientreceus	autres , et leur subgiez et alliés , soient receus
receusàleursraisonset	receus à leurs raisons et
defensesetsoiententelestatcommeilestoient	defenses et soient en tel estat comme il estoient
etdevoientestreautempsdesdisaccorsetparavant	et devoient estre au temps des dis accors et paravant
.13.Item,et	. 13 . Item , et
etvoulons,	et voulons ,
accordonsetoctroionsausdisprelas,gens	accordons et octroions aus dis prelas , gens
d'eglise,barons	d ' eglise , barons
,seigneurs,damesetautresdessusdis,et	, seigneurs , dames et autres dessus dis , et
etàleursalliésetsubgiez,que	et à leurs alliés et subgiez , que
eulxettousleurspaïssoient	eulx et tous leurs païs soient
doresenavanttenusenleurs	doresenavant tenus en leurs
usages,	usages ,
,franchises,libertésetcoustumesanciennes,telles	, franchises , libertés et coustumes anciennes , telles
commeleroysaintLoys,jadisroyde	comme le roy saint Loys , jadis roy de
France,etleconteAlphons,jadiscontede	France , et le conte Alphons , jadis conte de
de..Poitou,tindrentetavoientaccoustuméàtenir	de . . Poitou , tindrent et avoient accoustumé à tenir
leurspredecesseurs,etleurs	leurs predecesseurs , et leurs
dispaysetsubgiez,sansceque	dis pays et subgiez , sans ce que
chosequiaitestéousoitfaiteaucontrairepar	chose qui ait esté ou soit faite au contraire par
nous,nostre	nous , nostre
ditfrerede	dit frere de
Berry,ounospredecesseurs,	Berry , ou nos predecesseurs ,
,ouparautres,ouchosequi..s	, ou par autres , ou chose qui . . s
'ensoitensuiedepuisledittemps	' en soit ensuie depuis le dit temps
,leurfaceouporteprejudice,ouque	, leur face ou porte prejudice , ou que
quenousou	que nous ou
nosofficiers,nousenpuissionsaydier,oresne	nos officiers , nous en puissions aydier , ores ne
outempsavenir.14.Item,et	ou temps avenir . 14 . Item , et
etavec[.ce	et avec [ . ce
ce]voulonsetavonsoctroié	ce ] voulons et avons octroié
octroiéetoctroionsaus	octroié et octroions aus
prelas,	prelas ,
gensd'eglise	gens d ' eglise
,barons,seigneurs,damesetautres	, barons , seigneurs , dames et autres
dessusdis,etleursalliés	dessus dis , et leurs alliés
alliésetsubgiezque	alliés et subgiez que
,seeulxouaucuns	, se eulx ou aucuns
d'eulx.,	d ' eulx . ,
,pour.leursfaisoudeleurspredecesseurs	, pour . leurs fais ou de leurs predecesseurs
,estoientousonttenusetobligiésenaucunesrestes	, estoient ou sont tenus et obligiés en aucunes restes
restesdedeniersouautres	restes de deniers ou autres
chosesenversnous,ounostredit	choses envers nous , ou nostre dit
frerede	frere de
Berry,ouenla	Berry , ou en la
chambredenoscomptes	chambre de nos comptes
comptes,oudenostreditfrere,.ouenvers	comptes , ou de nostre dit frere , . ou envers
aucunsnosofficiersquiàpresentsontou	aucuns nos officiers qui à present sont ou
ouontesté,	ou ont esté ,
denostretempset	de nostre temps et
denostreditfrere,	de nostre dit frere ,
ou..denospredecesseurs,	ou . . de nos predecesseurs ,
,àcause	, à cause
desdis..offices	des dis . . offices
offices,parquelquecausequecesoit,	offices , par quelque cause que ce soit ,
queceulxquiobligiez	que ceulx qui obligiez
outenusenseroient,ensoientetdemeurentquictes	ou tenus en seroient , en soient et demeurent quictes
quictesetenpaix,etleurspleges,s'	quictes et en paix , et leurs pleges , s '
'aucuns..enya,et	' aucuns . . en y a , et
lesentenrons	les en tenrons
etferons	et ferons
tenirquittesenverstousceulxquiaucunechose	tenir quittes envers tous ceulx qui aucune chose
leurenporroientdemander.	leur en porroient demander .
15.Item.,et	15 . Item . , et
voulonsetavonsoctroiéetoctrions	voulons et avons octroié et octrions
ausprelas,gensd'	aus prelas , gens d '
eglise,barons,seigneurs,dames	eglise , barons , seigneurs , dames
damesetautresdessus[.dis],que	dames et autres dessus [ . dis ], que
eulxetchascund'	eulx et chascun d '
eulzsoient	eulz soient
soientetdemeurentfranchementetdelivreement,sansnul	soient et demeurent franchement et delivreement , sans nul
empeschementoucontradicionaucune,	empeschement ou contradicion aucune ,
ensaisinesetpossessionsdechoses	en saisines et possessions de choses
etdroisqueil	et drois que il
tiennentàpresent,et.queeulx	tiennent à present , et . que eulx
eulxetleurspredecesseursontacoustuméàteniroutempspassé	eulx et leurs predecesseurs ont acoustumé à tenir ou temps passé
passé,c'estassavoiràcausedeleur	passé , c ' est assavoir à cause de leur
leurancienheritage,queiltienentpaisiblement,	leur ancien heritage , que il tienent paisiblement ,
etdecequeilporront	et de ce que il porront
porrontmonstreràcestecauseàeulz	porront monstrer à ceste cause à eulz
appartenir,etvoulonsetleuroctroionsqueil	appartenir , et voulons et leur octroions que il
enjoissent	en joissent
paisiblement.etsans	paisiblement . et sans
empeschementaucun.	empeschement aucun .
16.Item,etleuravons	16 . Item , et leur avons
avonsaccordéet	avons accordé et
etoctroié,sicommeontfaitnosdis	et octroié , si comme ont fait nos dis
freres,	freres ,
,connestableetcousin,que	, connestable et cousin , que
queles.domagesquileurontesté	que les . domages qui leur ont esté
estéfaisdepuisetcontrelasoufrancequi..	esté fais depuis et contre la soufrance qui . .
leurfuoctroiée	leur fu octroiée
octroiéejusquesàlasaint	octroiée jusques à la saint
Andrieupassée,leurserontamendéset	Andrieu passée , leur seront amendés et
queilserontdesdommagiésde	que il seront des dommagiés de
toutcequi.	tout ce qui .
leuraestépriscontreladictesoufrance,	leur a esté pris contre la dicte soufrance ,
,dontilporrontensaigniersouffisanment,àce	, dont il porront ensaignier souffisanment , à ce
contraindronsou	contraindrons ou
feronscontraindretousceuxqu'	ferons contraindre tous ceux qu '
ilappartendra.17	il appartendra . 17
17.Item,etausprelas	17 . Item , et aus prelas
prelas,gensd'..	prelas , gens d ' . .
eglise,barons,seigneurs	eglise , barons , seigneurs
,damesetautres	, dames et autres
dessusdis,et..leursalliésetsubgiés	dessus dis , et . . leurs alliés et subgiés
,ettousleshabitansdespaïsde	, et tous les habitans des païs de
PoitouetdeXantongedessusdis,lesquelz	Poitou et de Xantonge dessus dis , les quelz
sontparledittraitié	sont par le dit traitié
deleurbonne	de leur bonne
volentévenusetretournésennostreobeissanceet	volenté venus et retournés en nostre obeissance et
subjection,avonsdeboncueretdebonnevolenté	subjection , avons de bon cuer et de bonne volenté
,quittié	, quittié
,remisetpardonné,etleurquittons,remettons	, remis et pardonné , et leur quittons , remettons
remettonsetpardonnonstoutehayne,ire,malivolence,courous	remettons et pardonnons toute hayne , ire , malivolence , courous
etrancune,s'aucunesavonseuou	et rancune , s ' aucunes avons eu ou
quenouspoonsavoir	que nous poons avoir
eu.contreeulxouaucunsd	eu . contre eulx ou aucuns d
d'eulx,pour	d ' eulx , pour
causedelarebellionoudesobeissance,s'	cause de la rebellion ou desobeissance , s '
'aucunesenontfaitesànous	' aucunes en ont faites à nous
ouà..nozgensetofficiers,en	ou à . . noz gens et officiers , en
entenantaussi	en tenant aussi
aussilepartidenostre	aussi le parti de nostre
adversaire,etpourquelconque	adversaire , et pour quelconque
autrecausequecesoit,etles	autre cause que ce soit , et les
avonsetrecevonsennostre	avons et recevons en nostre
benivolenceeten	benivolence et en
nostrebonnegrace.18.Item	nostre bonne grace . 18 . Item
,ettoutesleschosesdessusdicteset	, et toutes les choses dessus dictes et
chascuned'icelles,	chascune d ' icelles ,
sicommeellessontcontenues	si comme elles sont contenues
contenuesetdevisées,	contenues et devisées ,
nouspromettonsàteniretacomplirenbonne	nous promettons à tenir et acomplir en bonne
bonnefoyetenparolede	bonne foy et en parole de
roy,etàycellesfaireteniretacomplir	roy , et à ycelles faire tenir et acomplir
parnosdis	par nos dis
freres,connestableetsiredeCliçon,et	freres , connestable et sire de Cliçon , et
partousautresàquiilappartendra,sansvenir	par tous autres à qui il appartendra , sans venir
oufaireousouffrir[estrefait]encontre	ou faire ou souffrir [ estre fait ] encontre
parnousneparautre,enquelquemaniere	par nous ne par autre , en quelque maniere
quecesoit.	que ce soit .
.Sidonnonsenmandementetestroitementenjoignonsànos	. Si donnons en mandement et estroitement enjoignons à nos
amésetfeaulx.genstenantnostre	amés et feaulx . gens tenant nostre
presentparlementetquitendrontnosparlemensàvenir	present parlement et qui tendront nos parlemens à venir
,ausseneschausdePoitouetde	, aus seneschaus de Poitou et de
Xantonge,etàtousnosjusticiers..et	Xantonge , et à tous nos justiciers . . et
etofficiers,etlesjusticiers	et officiers , et les justiciers
denostreroyaume,ouàleurslieustenans	de nostre royaume , ou à leurs lieustenans
,.etàchascund'	, . et à chascun d '
eulx,si..commeàluiappartendra	eulx , si . . comme à lui appartendra
appartendra,queleschosesdessus.dictes	appartendra , que les choses dessus . dictes
iltiengnentetgardentet..	il tiengnent et gardent et . .
..acomplissent,	. . acomplissent ,
etfacentpartousceulxàquiilappartendra	et facent par tous ceulx à qui il appartendra
,garder,enterineretacomplir	, garder , enteriner et acomplir
,sansfaireousouffrir	, sans faire ou souffrir
souffrirparaucunsestrefaitlecontraire,etlesprelas	souffrir par aucuns estre fait le contraire , et les prelas
prelas,gensd	prelas , gens d
'eglise,barons,seigneurs,dameset	' eglise , barons , seigneurs , dames et
autresdessusdis	autres dessus dis
,etleursalliésetsubgiez,et..les	, et leurs alliés et subgiez , et . . les
habitansdes	habitans des
dispaysetchascund'eulz,facentet	dis pays et chascun d ' eulz , facent et
laissentjoiretuser	laissent joir et user
paisiblementdetousnosoctroiset	paisiblement de tous nos octrois et
gracesdessusdicteset	graces dessus dictes et
dechascunesd'..	de chascunes d ' . .
icelles,enrappellantetfaisantrappelleretremettre	icelles , en rappellant et faisant rappeller et remettre
aupremierestatetdeutoutceque	au premier estat et deu tout ce que
iltrouverontestrefaitcontreles	il trouveront estre fait contre les
leschosesdessusdictes,ouaucunes	les choses dessus dictes , ou aucunes
d'icelles	d ' icelles
,etcontrelateneur	, et contre la teneur
decespresentes,encontraignantàceviguereusement	de ces presentes , en contraignant à ce viguereusement
etdeuementtousceulxqu'ilappartendraetqui	et deuement tous ceulx qu ' il appartendra et qui
àceferontàcontraindre.Etpour.	à ce feront à contraindre . Et pour .
quece.soit	que ce . soit
soitfermechoseetestableà	soit ferme chose et estable à
àtousjours,nousavonsfait	à tousjours , nous avons fait
mettrenostreseel	mettre nostre seel
àcespresentes	à ces presentes
.Saufenautreschosesnostredroit	. Sauf en autres choses nostre droit
droitetl'autruientoutes.Ce	droit et l ' autrui en toutes . Ce
Cefufaitet..	Ce fu fait et . .
.donnéàParis,ennostrechastelduLouvre,	. donné à Paris , en nostre chastel du Louvre ,
lexvejourdedecembrel'andegrace	le xve jour de decembre l ' an de grace
milccc.lxxii..,etleneufviesmedenostre	mil ccc . lxxii . . , et le neufviesme de nostre
regne.Parleroy,ensonconseil.	regne . Par le roy , en son conseil .
G.deMontagu	G . de Montagu
