Charles,etc.Savoirfaisons	Charles , etc . Savoir faisons
àtous,presens	à tous , presens
etavenir,	et avenir ,
nousavoirreceul	nous avoir receu l
’umblesupplicacionde	’ umble supplicacion de
deNicolasFaye,	de Nicolas Faye ,
clerc,.demourantàThouarsenPoictou,contenant	clerc , . demourant à Thouars en Poictou , contenant
qu’ilabienetloyaumentservi.nous	qu ’ il a bien et loyaument servi . nous
etnostretrèschieretamé.oncle	et nostre très chier et amé . oncle
leducdeBerryetd’	le duc de Berry et d ’
Auvergne,contedePoictou,parl	Auvergne , conte de Poictou , par l
’espacededixhuitansou	’ espace de dix huit ans ou
environ,enl’officedelieutenantoupays	environ , en l ’ office de lieutenant ou pays
deThouarçoysdureceveurouditpaysdePoictousur	de Thouarçoys du receveur ou dit pays de Poictou sur
surlefaitdesaidesordonnéespour	sur le fait des aides ordonnées pour
laguerre,etque	la guerre , et que
,troisansaouenviron,durant	, trois ans a ou environ , durant
letempsdeladictelieutenanceduditsuppliant,	le temps de la dicte lieutenance du dit suppliant ,
,..certainprocèss’	, . . certain procès s ’
’assistpardevantles	’ assist par devant les
esleuzsurlefaitdesdizaidesouditpays	esleuz sur le fait des diz aides ou dit pays
dePoictou,àleursiege	de Poictou , à leur siege
dePoictiers,entreunappelléDaneya,fermierde	de Poictiers , entre un appellé Daneya , fermier de
depluseursfermesdesdizaidesou	de pluseurs fermes des diz aides ou
ditpaysdeThouarçoys,d’	dit pays de Thouarçoys , d ’
’unepart,etledit.suppliant,	’ une part , et le dit . suppliant ,
d’autre	d ’ autre
autre,disantleditDaneyaqueilavoitpluspaié	autre , disant le dit Daneya que il avoit plus paié
paiédesdictesfermesauditsuppliantqueilnelui	paié des dictes fermes audit suppliant que il ne lui
vouloitallouerensoncompte;	vouloit allouer en son compte ;
lequelprocèsduraparl’	lequel procès dura par l ’
espacededeuxansouenviron,dontledit	espace de deux ans ou environ , dont le dit
suppliant,soysententde	suppliant , soy sentent de
ceinjuriéettraveillié	ce injurié et traveillié
,etmeudeirecontreleditDaneya,	, et meu de ire contre ledit Daneya ,
àuncertainjourd’	à un certain jour d ’
unmoysou	un moys ou
environparavantle	environ paravant le
ledelitdontcyaprès	le delit dont cy après
serafaictemencion,distàJehanninGobetet	sera faicte mencion , dist à Jehannin Gobet et
àunautredontilnescetlenom	à un autre dont il ne scet le nom
,lesquelz	, lesquelz
lesquelziltrouvaouvillage	lesquelz il trouva ou village
deSaintJoyndeMarnes,queledit	de Saint Joyn de Marnes , que le dit
Daneyaletenoit	Daneya le tenoit
enprocèsen	en procès en
enladictevilledePoictiers,devantlesdiz	en la dicte ville de Poictiers , devant les diz
dizesleuz,en..luifaisant	diz esleuz , en . . lui faisant
grant..injureetvillenie	grant . . injure et villenie
villeniedecedontilplaidoioitàlui,et.	villenie de ce dont il plaidoioit à lui , et .
priaicelluisuppliantauditGobetqu	pria icellui suppliant au dit Gobet qu
qu’..ilenfeustvengié.LequelGobetlui	qu ’ . . il en feust vengié . Lequel Gobet lui
respondiqu’ill’enlaissastfaireet	respondi qu ’ il l ’ en laissast faire et
qu’ill’en.vengeroit	qu ’ il l ’ en . vengeroit
bien,ettantque,environlafin	bien , et tant que , environ la fin
dumoysde	du moys de
janvierl’anmil	janvier l ’ an mil
cccc.etsix,àuncertain	cccc . et six , à un certain
jourqueleditDaneyas’estoitpartide	jour que le dit Daneya s ’ estoit parti de
ladictevilledeThouars	ladicte ville de Thouars
,oùildemeure	, où il demeure
,pouralerobeiràcertaineassignacionqu’il	, pour aler obeir à certaine assignacion qu ’ il
ilavoitenladictecausepardevantlesdizesleuz	il avoit en la dicte cause par devant les diz esleuz
esleuz,leditJehanninGobetettroisautressescomplices	esleuz , ledit Jehannin Gobet et trois autres ses complices
encontrerenticellui	encontrerent icellui
Daneyaou	Daneya ou
ditchemin,près.d	dit chemin , près . d
’unlieuappelléleLitSaintJoyn,et	’ un lieu appellé le Lit Saint Joyn , et
làseprindrentaucorpsdudit	là se prindrent au corps du dit
Daneyaetluidonnerentdeuxoutroiscopsde	Daneya et lui donnerent deux ou trois cops de
platd’espéeet[	plat d ’ espée et [
le]mistrentà	le ] mistrent à
àterredesursoncheval,eticelluicheval	à terre de sur son cheval , et icellui cheval
luiosterent.	lui osterent .
avec.sonargent,unedague,	avec . son argent , une dague ,
undoubler,ensemblecertaineslettresestansdedensicellui	un doubler , ensemble certaines lettres estans dedens icellui
doubleretunebouteille,lequelcheval,sicomme	doubler et une bouteille , lequel cheval , si comme
distleditDaneya,estoitdelavaleurde	dist le dit Daneya , estoit de la valeur de
de.iiii.livres	de . iiii . livres
ouenviron,etmontoitleditargentàicellui	ou environ , et montoit le dit argent à icellui
Daneyaosté.par	Daneya osté . par
le..ditGobet	le . . dit Gobet
etsesdizcomplicesàla	et ses diz complices à la
sommedetrente..	somme de trente . .
solzouenviron,etladicte	solz ou environ , et la dicte
dictebouteilleestoitdelavaleur	dicte bouteille estoit de la valeur
valeurdeii.solzparisisouenviron.	valeur de ii . solz parisis ou environ .
DuqueldelitleditDaneyaencoulpale	Du quel delit le dit Daneya encoulpa le
ditsuppliantetqu..’	dit suppliant et qu . . ’
ilavoitdonné..oupromisargentpourcefaire	il avoit donné . . ou promis argent pour ce faire
faire.Etpour	faire . Et pour
pourceseaccordaleditsuppliantavecicelluiDaneya,	pour ce se accorda le dit suppliant avec icellui Daneya ,
tant.duditprocèsquiestoit	tant . du dit procès qui estoit
estoit.pendantentreeulxcommedu	estoit . pendant entre eulx comme du
duditdelit	du dit delit
etprinsedebiens,etl’ena	et prinse de biens , et l ’ en a
quictiéetquicte,sicommeparlettresfaictes	quictié et quicte , si comme par lettres faictes
surleditaccortpeutplusà	sur le dit accort peut plus à
àplainapparoir.Etneantmoinspourle	à plain apparoir . Et neantmoins pour le
leditcasicelluisuppliant	le dit cas icellui suppliant
aestéetest	a esté et est
prisonnierou..eneslargissement,	prisonnier ou . . en eslargissement ,
,soubzla	, soubz la
lajusticedenostreaméet	la justice de nostre amé et
feal.cousinle	feal . cousin le
viconteduditlieu	viconte du dit lieu
lieudeThouars,oùilestdemourant,	lieu de Thouars , où il est demourant ,
etseroitdece.leditsuppliantengrant	et seroit de ce . le dit suppliant en grant
dangierdejustice,separnousneluiestoit	dangier de justice , se par nous ne lui estoit
surceestenduenostre	sur ce estendue nostre
grace,sicommeildit,requerant	grace , si comme il dit , requerant
requeranthumblementicelle.Pourceestil	requerant humblement icelle . Pour ce est il
ilquenous,ceschosesconsiderées,	il que nous , ces choses considerées ,
,etc.,àicelluisuppliant	, etc ., à icellui suppliant
,etc.,avons	, etc ., avons
quictié,remisetpardonné,etc.Sidonnons	quictié , remis et pardonné , etc . Si donnons
enmandementparcesmesmespresentesànostrebailli	en mandement par ces mesmes presentes à nostre bailli
baillideTouraineetdesressors	bailli de Touraine et des ressors
etExempcionsde	et Exempcions de
dePoictou,d’.AnjouetduMaine	de Poictou , d ’ . Anjou et du Maine
,etàtousnozautresjusticiers,etc	, et à tous noz autres justiciers , etc
.DonnéàParis,	. Donné à Paris ,
,oumoysdeseptembrel’	, ou moys de septembre l ’
’andegrace	’ an de grace
gracemilcccc.ethuit.,et	grace mil cccc . et huit . , et
denostreregnelexxixe.	de nostre regne le xxixe .
.Parleroy,àlarelaciondu	. Par le roy , à la relacion du
conseil.Dominique.	conseil . Dominique .
