Philippes,etc.,ànozamésetfeauxG	Philippes , etc ., à noz amés et feaux G
.delaRajace	. de la Rajace
RajaceetP...delaBroce,	Rajace et P . . . de la Broce ,
chevaliers,salut.Comme..nous	chevaliers , salut . Comme . . nous
eussiensparnos	eussiens par nos
autreslettressemonsetrequisetfaitsemonreetrequerir..	autres lettres semons et requis et fait semonre et requerir . .
requerretouzles.noblesdetelballiedesseneschauciede	requerre touz les . nobles de tel ballie des seneschaucie de
Poitou.et	Poitou . et
bailliedeTouraine,de	baillie de Touraine , de
quelqueestatque	quelque estat que
queilsoient,soient	que il soient , soient
baron,chevalierouescuier,queilfussenten	baron , chevalier ou escuier , que il fussent en
enchevauxetenarmesaveques	en chevaux et en armes aveques
nousàArras,àcesteprochaine	nous à Arras , à ceste prochaine
prochainefestesaintJehan,pouraleravequesnousen	prochaine feste saint Jehan , pour aler aveques nous en
nostrebesoignedeFlandres,etpourceque	nostre besoigne de Flandres , et pour ce que
quenousnepoonsveoir	que nous ne poons veoir
quenouspeussiensavoirnozgenzjusquesà	que nous peussiens avoir noz genz jusques à
àlaquinzainedela.ditefestesaintJehan,pour	à la quinzaine de la . dite feste saint Jehan , pour
cequeilsepuissentmielzpourvoermiez	ce que il se puissent mielz pourvoer miez
miezpourveoiretarreerànousservirenladite	miez pourveoir et arreer à nous servir en la dite
besoigne,vous..envoions	besoigne , vous . . envoions
enceleballie	en cele ballie
balliecelesbaillieetseneschauciepoureusfaire	ballie celes baillie et seneschaucie pour eus faire
savoirnostrevolentévoulenté.Sivouscommetonsetmandons	savoir nostre volenté voulenté . Si vous commetons et mandons
quevousce..leurfaitessavoiretlesrequerezet	que vous ce . . leur faites savoir et les requerez et
etsemonnezdeparnous	et semonnez de par nous
,siestroitementetsiaffectueusementcommevous	, si estroitement et si affectueusement comme vous
pourrez,queil	pourrez , que il
ilàladitequinzaine	il à la dite quinzaine
,sanznuldefaut,..arreéet	, sanz nul defaut , . . arreé et
etapparelliéappareliéenchevauxetenarmes,	et apparellié apparelié en chevaux et en armes ,
pourvenir	pour venir
avecquesavequesnousetnousservirennostre	avecques aveques nous et nous servir en nostre
nostreditebesoigne,entellemanierequenousleur	nostre dite besoigne , en telle maniere que nous leur
ensachiens	en sachiens
saichonsgréetquepar..cenouspuissiensveoir	saichons gré et que par . . ce nous puissiens veoir
leurbonnevolentévoulentéversnous	leur bonne volenté voulenté vers nous
etversnostreroyaume.DonnéàVincennes,	et vers nostre royaume . Donné à Vincennes ,
lejourdefeste	le jour de feste
saintBarnabél'apostre,l'an	saint Barnabé l ' apostre , l ' an
degrâcem.	de grâce m .
ccc.etquatre	ccc . et quatre
