Charles,etc.Savoirfaisonsàtous,presens	Charles , etc . Savoir faisons à tous , presens
etavenirque,oyelasupplicaciondeGuillaumeRochier	et avenir que , oye la supplicacion de Guillaume Rochier
,povrehommelaboureur	, povre homme laboureur
,demourantàChevetonneoudiocesedePoictiers,	, demourant à Chevetonne ou diocese de Poictiers ,
,chargiédefemmegrosseetd'unpetitenfant	, chargié de femme grosse et d ' un petit enfant
,contenantquecommecertaine	, contenant que comme certaine
certainenoiseetdebatsefeustmue	certaine noise et debat se feust mue
entreleditsuppliant,d'unepart	entre le dit suppliant , d ' une part
,etHuguetRochier,sonfrere,d'	, et Huguet Rochier , son frere , d '
autre,dèsla.festede	autre , dès la . feste de
sainctJehanBaptistequifu	sainct Jehan Baptiste qui fu
l'anmilCCC	l ' an mil CCC
CCCIIIIXXet	CCC IIIIXX et
ettreze,ouaumoinslelundi	et treze , ou au moins le lundi
aprèsensuivant,ou	après ensuivant , ou
lieuquel'enditde	lieu que l ' en dit de
Chevetonne,ettantqueleditsuppliant,	Chevetonne , et tant que le dit suppliant ,
quiest.jeuneshomsetquiestoitmainsnédudit	qui est . jeunes homs et qui estoit mainsné du dit
ditHuguet,..	dit Huguet , . .
sonfrere,souffripluseursgransinjures	son frere , souffri pluseurs grans injures
etvilleniesdelui,etlesportapaciemment;	et villenies de lui , et les porta paciemment ;
ettantle	et tant le
menaleditHuguetque	mena le dit Huguet que
que,ainsiqu'ilzestoient	que , ainsi qu ' ilz estoient
estoientunefoisèsprezduditlieude	estoient une fois ès prez du dit lieu de
Chevetonne,oùle	Chevetonne , où le
dit..suppliantne	dit . . suppliant ne
nepensoitànulmal,ainscuidoit	ne pensoit à nul mal , ains cuidoit
estreavec.	estre avec .
sonditfrerepaisiblement,et	son dit frere paisiblement , et
ainsiqu'ilzfauchoientèsdizprez	ainsi qu ' ilz fauchoient ès diz prez
ensemble,leditHuguetnelaissoiten	ensemble , le dit Huguet ne laissoit en
paixleditsuppliant	paix le dit suppliant
,sonfrere,etde	, son frere , et de
faitluicouri..sus,	fait lui couri . . sus ,
etpourresisteràsamalevolonté,	et pour resister à sa male volonté ,
yceluisuppliantlefuioittousjours,etauderrenierconvint	ycelui suppliant le fuioit tousjours , et au derrenier convint
qu'ilsedefendist,	qu ' il se defendist ,
ouautrementilluifeustmescheudu	ou autrement il lui feust mescheu du
corps;etquantilvit	corps ; et quant il vit
vitqu'ilnepovoitresister	vit qu ' il ne povoit resister
encontre.son	encontre . son
ditfrere,yceluisuppliantlefrappadubecd.	dit frere , ycelui suppliant le frappa du bec d .
'unefauxà	' une faux à
fauchierprez,etluifistuneplaieen	fauchier prez , et lui fist une plaie en
enlateste,dontledit	en la teste , dont le dit
Huguetne.tintoncques	Huguet ne . tint oncques
compte,etfistsabesongne,sateste	compte , et fist sa besongne , sa teste
toutedescouverte,ettantquela	toute descouverte , et tant que la
pluyeentra	pluye entra
dedenssadicteplaie,combienqueleditsuppliant	dedens sa dicte plaie , combien que le dit suppliant
suppliantlisignifiastetfeistsignifierparpluseursfoizqu	suppliant li signifiast et feist signifier par pluseurs foiz qu
'ilfeustappareillé,dontilnevoultriens.	' il feust appareillé , dont il ne voult riens .
.faire.,et	. faire . , et
disoitqu'iln	disoit qu ' il n
'estoitpointblecié	' estoit point blecié
.Duquel	. Du quel
cop,combienquepluseurs	cop , combien que pluseurs
personnesencecongnoissans..aient	personnes en ce congnoissans . . aient
depuisditque	depuis dit que
,seilse	, se il se
feustfaitapparillier,iln'eusteu	feust fait apparillier , il n ' eust eu
eugardeduditcop..,neantmoinsyceluiHuguet	eu garde du dit cop . . , neantmoins ycelui Huguet
acouchamaladeetvesquidepuisleditcop	acoucha malade et vesqui depuis le dit cop
copjusquesausamediaprèsensuivant.Pour	cop jusques au samedi après ensuivant . Pour
occasionduquelfait	occasion duquel fait
,yceluisuppliantquitout	, ycelui suppliant qui tout
sontemps.aesté	son temps . a esté
estédebonnevieetrenommée	esté de bonne vie et renommée
,sanzavoirestéactaintd'	, sanz avoir esté actaint d '
aucunautrevillainreprouche,estenaventured'	aucun autre villain reprouche , est en aventure d '
'estre.desertetfuitifàtousjours,se	' estre . desert et fuitif à tousjours , se
parnousneluiestsurce	par nous ne lui est sur ce
impartienostregraceetmisericorde,si	impartie nostre grace et misericorde , si
commeildit...Etpource	comme il dit . . . Et pour ce
nousahumblementsupplié	nous a humblement supplié
suppliéque,	supplié que ,
,considéréceque..ditest	, considéré ce que . . dit est
estetqueleditHuguet,avantqu'il	est et que le dit Huguet , avant qu ' il
alastdevieàtrespassement,congnutet	alast de vie à trespassement , congnut et
confessa,enlapresencedu	confessa , en la presence du
chappellain.quiluiadministra	chappellain . qui lui administra
lecorpsde	le corps de
NostreSeigneurJhesuCrist,etde	Nostre Seigneur Jhesu Crist , et de
deplusieursautres	de plusieurs autres
personnes,queleditfaitestoitadvenupar	personnes , que le dit fait estoit advenu par
luietparcequ	lui et parce qu
qu'ilmettoitpeinedetuerleditsuppliant	qu ' il mettoit peine de tuer le dit suppliant
,sonfrere,etlui	, son frere , et lui
pardonnasamort,nousluivueillons	pardonna sa mort , nous lui vueillons
nostredictegraceimpartiretluiestremisericors.Nous	nostre dicte grace impartir et lui estre misericors . Nous
Nousinclinansàsasupplicacion,.consideransles	Nous inclinans à sa supplicacion , . considerans les
leschosesdessusdictes,etc.,	les choses dessus dictes , etc .,
auditsuppliantoucas	au dit suppliant ou cas
dessusditavonspardonné	dessus dit avons pardonné
,quictiéetremis,etc.Sidonnons	, quictié et remis , etc . Si donnons
enmandementparcespresentesaubaillideTouraineet	en mandement par ces presentes au bailli de Touraine et
àtousnozautresjusticiers,	à tous noz autres justiciers ,
etc.Donné	etc . Donné
DonnéàParis,oumoisdenovembre	Donné à Paris , ou mois de novembre
l'andegrace	l ' an de grace
milCCC.IIIIXXXVetdenostreregne	mil CCC . IIIIXX XV et de nostre regne
leXVIe...Parleroy,àla	le XVIe . . . Par le roy , à la
relacionduconseil.Chaligaut.	relacion du conseil . Chaligaut .
