Charles,parlagracedeDieuroyde	Charles , par la grace de Dieu roy de
deFrance.Savoirfaisonsàtouz,	de France . Savoir faisons à touz ,
presensetavenir,ànousavoirestéhumblement	presens et avenir , à nous avoir esté humblement
exposédelapartiedesamischarnelzde.	exposé de la partie des amis charnelz de .
JehanViset,povre	Jehan Viset , povre
homme,laboureurdel'	homme , laboureur de l '
aagedeXXIansouenviron.	aage de XXI ans ou environ .
,que,commeGuillaumeVisetetKatin	, que , comme Guillaume Viset et Katin
Katin,safemme	Katin , sa femme
,pereetmere	, pere et mere
duditJehan,soientet.aientestéconjoinspar	du dit Jehan , soient et . aient esté conjoins par
mariageensambleetdurantleurmariageeussentmariée	mariage ensamble et durant leur mariage eussent mariée
PerroteVisete,filledudit.	Perrote Visete , fille du dit .
GuillaumeVisetd'unautremariage,avecques	Guillaume Viset d ' un autre mariage , avecques
unappellé..Michiel	un appellé . . Michiel
Baster,etdepuislesnocesfaictesleditBaster	Baster , et depuis les noces faictes le dit Baster
eustdemandéauxdiz	eust demandé aux diz
Guillaumeet.	Guillaume et .
.Katinlapart	. Katin la part
partetporcion	part et porcion
appartenantàsadictefemme,	appartenant à sa dicte femme ,
àcausedecertainsbiensmeubles,	à cause de certains biens meubles ,
entrelesquelzavoitbestesàlaine	entre lesquelz avoit bestes à laine
àpartir	à partir
partiretdiviser,et.	partir et diviser , et .
.enfaisantle	. en faisant le
ditpartageleditBaster,parson	dit partage le dit Baster , par son
grantoultrage,s'efforçadeprendre	grant oultrage , s ' efforça de prendre
prendreetenmenerparforceet..contrela	prendre et enmener par force et . . contre la
voulentédeladicteKatin,	voulenté de la dicte Katin ,
aveclaquelle.	avec laquelle .
.ilfaisoitlepartagedesdictes	. il faisoit le partage des dictes
bestes,l'unedesplusbellesbestes	bestes , l ' une des plus belles bestes
quifeustoumonceau	qui feust ou monceau
etfaratdesdictesbrebiz.	et farat des dictes brebiz .
..EtpourcequeladicteKatinlecontredist	. . Et pour ce que la dicte Katin le contredist
contredist,ycelluiBasterluidistpluseursgransinjuresetvilenies	contredist , ycellui Baster lui dist pluseurs grans injures et vilenies
,etdefaitpourcequeladicteKatin	, et de fait pour ce que la dicte Katin
Katin..s'efforçad	Katin . . s ' efforça d
'empeschierqu'	' empeschier qu '
ilneenmenastladictebrebiz,..ledit	il ne enmenast la dicte brebiz , . . le dit
Basterquiestoitgrantjeunes	Baster qui estoit grant jeunes
homsetfortbatietferimoult	homs et fort bati et feri moult
moultdurementet	moult durement et
etinhumainement..ladicteKatin	et inhumainement . . la dicte Katin
etlagectaàterre,et	et la gecta à terre , et
telementqu'ellene	telement qu ' elle ne
sepovoitleverneaidier;surlequelfaitle	se povoit lever ne aidier ; sur lequel fait le
leditJehanVisetarrivad'aventureetlui	le dit Jehan Viset arriva d ' aventure et lui
lui,meud'amour	lui , meu d ' amour
maternelle,voyantsa	maternelle , voyant sa
sadictemere	sa dicte mere
mereestreainsidurementvilenée	mere estre ainsi durement vilenée
vilenéeetbatue,	vilenée et batue ,
et.quele	et . que le
ditBasternes'encessoitautrement,	dit Baster ne s ' en cessoit autrement ,
maisprocedoit	mais procedoit
procedoit..tousjourspargrantfelonnieàbatrela	procedoit . . tousjours par grant felonnie à batre la
dicteKatinquiestvielleetancienne,	dicte Katin qui est vielle et ancienne ,
sachauncoustelqu'ilportoit,	sacha un coustel qu ' il portoit ,
etdefaitparchaudecoleferile.ditBaster	et de fait par chaude cole feri le . dit Baster
Basterd'uncousteltelementquemorts	Baster d ' un coustel telement que mort s
'enensuy..enla	' en ensuy . . en la
personneduditBaster.Pourlequelfait,	personne du dit Baster . Pour le quel fait ,
ycelluiJehanVisetaestéprinset	ycellui Jehan Viset a esté prins et
etestdetenuprisonnierèsprisonsdenostreaméetfeal	et est detenu prisonnier ès prisons de nostre amé et feal
leseigneurdePartenay,etdepuisaestérendu	le seigneur de Partenay , et depuis a esté rendu
renduen..laprisondenostreaméetfealJehanGirart	rendu en . . la prison de nostre amé et feal Jehan Girart
chevalier,commesonsubgietet	chevalier , comme son subgiet et
justiciable,etestenvoyed'estrepuniz	justiciable , et est en voye d ' estre puniz
puniz..corporelmentleditJehan,	puniz . . corporelment le dit Jehan ,
senostregraeceetmisericordene	se nostre graece et misericorde ne
liestsur	li est sur
ceeslargie	ce eslargie
eslargie;ennoushumblement	eslargie ; en nous humblement
suppliantque	suppliant que
que,comme.entousautrescasle	que , comme . en tous autres cas le
ditJehanVisetaitestéet.soitde	dit Jehan Viset ait esté et . soit de
bonnevie,fame.,renommée	bonne vie , fame . , renommée
ethonneste	et honneste
conversacion,sanzonquesavoirestéattaintne	conversacion , sanz onques avoir esté attaint ne
convaincud'aucunautre	convaincu d ' aucun autre
villainblasme,et	villain blasme , et
quepouroccasiondu	que pour occasion du
ditfaitleditJehanYisetaesté.et	dit fait le dit Jehan Yiset a esté . et
etdemouréprisonnierparl'espacedetroisans	et demouré prisonnier par l ' espace de trois ans
ouenviron,àgrantmisereetpovreté	ou environ , à grant misere et povreté
,pourledébatdes	, pour le débat des
dizsiredePartenayetduditJehanGirart,	diz sire de Partenay et du dit Jehan Girart ,
noussur	nous sur
surceluivueillonsimpartirnostredictegraceetmisericorde.	sur ce lui vueillons impartir nostre dicte grace et misericorde .
Pourquoynous,etc.,lefait	Pour quoy nous , etc ., le fait
dessusdit,etc.,avonsremis,	dessus dit , etc ., avons remis ,
quictiéetpardonné,etc.Sidonnons	quictié et pardonné , etc . Si donnons
donnonsenmandementpar..	donnons en mandement par . .
cesmesmespresentesaugouverneurdelaRochelleetà	ces mesmes presentes au gouverneur de la Rochelle et à
àtouz..nozautres	à touz . . noz autres
justiciers,etc	justiciers , etc
.Donnéà	. Donné à
Paris,oumoysd'avrill'an	Paris , ou moys d ' avril l ' an
degrace	de grace
gracemilCCCIIIIXXetXII,et	grace mil CCC IIIIXX et XII , et
denostreregneleXIIe.Par	de nostre regne le XIIe . Par
leroy,àlarelaciondu	le roy , à la relacion du
conseil.	conseil .
