Charles,etc.Savoirfaisonsà	Charles , etc . Savoir faisons à
tous,presensetadvenir	tous , presens et advenir
,commedèsletempsdenostre	, comme dès le temps de nostre
nostrejeuneaage,quefeusmes	nostre jeune aage , que feusmes
par.mariaigeconjoings	par . mariaige conjoings
conjoingsavecquesnostretrèschiereettrèsaméecompaignelaroyne	conjoings avecques nostre très chiere et très amée compaigne la royne
,.nousfeussions	, . nous feussions
trouvépresentàla	trouvé present à la
naissancede	naissance de
denostretrèschieret	de nostre très chier et
très.amé	très . amé
frereetcousinCharlesd	frere et cousin Charles d
’Anjou,àpresentconteduMaineetde	’ Anjou , à present conte du Maine et de
Mortaing,qui	Mortaing , qui
dèsl’eure	dès l ’ eure
desanativité[par]feuedebonnememoire	de sa nativité [ par ] feue de bonne memoire
nostretrèschereet	nostre très chere et
trèsaméemereYolant	très amée mere Yolant
Yolant,ensonvivantroynedeJherusalem.	Yolant , en son vivant royne de Jherusalem .
etdeSicile,samere,nous	et de Sicile , sa mere , nous
futdonnéetbailléen	fut donné et baillé en
especialrecommandacion;	especial recommandacion ;
;lequel,incontinentetsitostqu’	; lequel , incontinent et si tost qu ’
ilfutenaaged’avoir	il fut en aage d ’ avoir
congnoissancedesgransafferesquepourlorsavions	congnoissance des grans afferes que pour lors avions
,àl’occasion	, à l ’ occasion
desguerresdenostreroyaume,etqu	des guerres de nostre royaume , et qu
’ileutpuissance	’ il eut puissance
desuivirlesarmes,setira	de suivir les armes , se tira
deversnouseten	devers nous et en
nostreservice,	nostre service ,
ouqueljusquesàpresents’estcontinuellement	ouquel jusques à present s ’ est continuellement
tenusansdepartir,etentouz	tenu sans departir , et en touz
voyaiges,	voyaiges ,
arméesetentreprisesquenousavonsdepuis	armées et entreprises que nous avons depuis
faictes,seestemployédecorps,dechevance	faictes , se est employé de corps , de chevance
etdetouzsesautresbiens,tantque	et de touz ses autres biens , tant que
possibleluiaesté,sansriensyespergnier	possible lui a esté , sans riens y espergnier
espergnierneavoirregartàdomageouautreinconvenientquipour	espergnier ne avoir regart à domage ou autre inconvenient qui pour
celuipeustadvenir,en..demonstrant	ce lui peust advenir , en . . demonstrant
demonstrantetdesclairantpareffectla..vraye,	demonstrant et desclairant par effect la . . vraye ,
,parfaicte,naturelle	, parfaicte , naturelle
naturelleetsinguliereamourqu	naturelle et singuliere amour qu
’ilavoitànostrepersonneetaubien	’ il avoit à nostre personne et au bien
etexaltacionde	et exaltacion de
nostreseigneurie	nostre seigneurie
seigneurie,pourlaquelleà	seigneurie , pour laquelle à
sonpovoir..releveretdescharger	son povoir . . relever et descharger
deschargerdesoppressionsetdomaigesque	descharger des oppressions et domaiges que
quenozanciensennemis	que noz anciens ennemis
lesAngloysyontfaizetchascunjour	les Angloys y ont faiz et chascun jour
s’efforcent.de	s ’ efforcent . de
faire,iceluinostre..	faire , icelui nostre . .
.frereetcousindesirant,ainsiquepar	. frere et cousin desirant , ainsi que par
experienceilabienmonstré,l’expulsion,	experience il a bien monstré , l ’ expulsion ,
,deboutementetconfusiond	, deboutement et confusion d
’iceulx	’ iceulx
iceulx,a	iceulx , a
adèslongtempsdeluimeismesetcommenostre	a dès longtemps de lui meismes et comme nostre
nostrelieutenantgeneralsurlefaitde	nostre lieutenant general sur le fait de
laguerreèspaïsd	la guerre ès païs d
’Anjouet	’ Anjou et
duMaineetdelaBasseNormandie	du Maine et de la Basse Normandie
,entretenulesgens	, entretenu les gens
estansèsfrontieresdespays.dessus	estans ès frontieres des pays . dessus
dizetencoresentretient,eten	diz et encores entretient , et en
eniceulxfaitplusieursbellesdestroussesetrencontressurnos	en iceulx fait plusieurs belles destrousses et rencontres sur nos
dizennemis;et	diz ennemis ; et
quiplusest,depuisgranttemps	qui plus est , depuis grant temps
ença,non	en ça , non
sansgrans.labeur	sans grans . labeur
,paine,travailetsoussy,	, paine , travail et soussy ,
,avertueusementsoustenuetencores.soustient	, a vertueusement soustenu et encores . soustient
lefaitdesfrontieresdeEvreux	le fait des frontieres de Evreux
,Pontoise,Louviersetautresplaces	, Pontoise , Louviers et autres places
placesestansdepresentenlafrontieredenosdizennemis	places estans de present en la frontiere de nosdiz ennemis
ennemisduditpaïsdeNormandie.Etd’	ennemis dudit païs de Normandie . Et d ’
’abondant,pourplussoymonstrerafectionné	’ abondant , pour plus soy monstrer afectionné
ennostre	en nostre
ditserviceetavoirnoz	dit service et avoir noz
afferesàcuer,a	afferes à cuer , a
atousjoursentretenu.plusieurs	a tousjours entretenu . plusieurs
plusieurscappitainesetgensdeguerrequicontinuelmentnous	plusieurs cappitaines et gens de guerre qui continuelment nous
ontobei,servi..etserventàtouz	ont obei , servi . . et servent à touz
touzlessiegesetentreprisesquenous	touz les sieges et entreprises que nous
nous..avonsfaictesà	nous . . avons faictes à
àl’encontre	à l ’ encontre
denosdizennemis;àl’	de nos diz ennemis ; à l ’
occasiondesquelleschargesluiaconvenuetconvientfaire	occasion desquelles charges lui a convenu et convient faire
etsupporter	et supporter
,enoultre.lesinestimables	, en oultre . les inestimables
inestimablesperilzde..sapersonne	inestimables perilz de . . sa personne
,plusieurs	, plusieurs
gransfraiz,misesetdespens,	grans fraiz , mises et despens ,
sanscequeparnouspour.letemps	sans ce que par nous pour . le temps
tempspasséaitesté	temps passé ait esté
soustenu,payé	soustenu , payé
nesouldoyé,.ouavoireuaidequedepo	ne souldoyé , . ou avoir eu aide que de po
dechose,nelesdiz	de chose , ne les diz
servicesestrerecongneuzoupource	services estre recongneuz ou pour ce
faitaucunerecompensejusquesà	fait aucune recompense jusques à
present,ainsique	present , ainsi que
nousyrepputonsbienàtenuz.Pourquoynous	nous y repputons bien à tenuz . Pour quoy nous
,aiansconsideracionès	, aians consideracion ès
chosesdessus..dictes	choses dessus . . dictes
dictes,àlaproximitédulignageetaffinité	dictes , à la proximité du lignage et affinité
affinitéenquoynous	affinité en quoy nous
nousattienticeluinostreditfrereetcousin,	nous attient icelui nostre dit frere et cousin ,
freregermaindenostredictecompaigne	frere germain de nostre dicte compaigne
,etquelaplus	, et que la plus
grantpartiede	grant partie de
saterreetseigneuriepatrimonialestà.	sa terre et seigneurie patrimonial est à .
.presentoccuppéeparnosdizanciensennemis,	. present occuppée par nos diz anciens ennemis ,
etaussique	et aussi que
quedece	que de ce
cenousatrèshumblementetinstamment	ce nous a très humblement et instamment
suppliéetrequisnostretrèschieret	supplié et requis nostre très chier et
trèsaméainsnéfilz,ledaulphinde	très amé ainsné filz , le daulphin de
Viennoys,affindetousjoursleesmouvoiretastraindreà	Viennoys , affin de tousjours le esmouvoir et astraindre à
soyemployerdebienenmieulxen	soy employer de bien en mieulx en
ennostreditserviceetdonnerauxautresexemple	en nostre dit service et donner aux autres exemple
exempledepareillementfaire,àicelui	exemple de pareillement faire , à icelui
nostreditfrereetcousin,pources	nostre dit frere et cousin , pour ces
cescauseset.autres,eusur	ces causes et . autres , eu sur
sur.cepremierement	sur . ce premierement
premierementl’advisetdeliberaciondes	premierement l ’ advis et deliberacion des
desgensdenostre	des gens de nostre
nostregrantconseil.,etpourplusieursconsideracionsà	nostre grant conseil . , et pour plusieurs consideracions à
àceraisonnablementnousmouvans	à ce raisonnablement nous mouvans
,avonsaujourd	, avons aujourd
aujourd’uy,denostrecertainescience	aujourd ’ uy , de nostre certaine science
,puissanceespecial,graceetauctoritéroyal	, puissance especial , grace et auctorité royal
,baillé	, baillé
,donné,	, donné ,
cedé,transportéetdelaissé,	cedé , transporté et delaissé ,
,baillons,donnons,cedons,transportonsetdelaissons	, baillons , donnons , cedons , transportons et delaissons
parcespresentesperpetuelment,parheritaigeet	par ces presentes perpetuelment , par heritaige et
àtousjoursmais,pardonnaisonvallablefaicteentreles	à tousjours mais , par donnaison vallable faicte entre les
vifs,pourlui,seshoirsetsuccesseurs	vifs , pour lui , ses hoirs et successeurs
masles,descendanslegitimementde	masles , descendans legitimement de
desachar,etles	de sa char , et les
heritiersmasleslegitimesdescendansd	heritiers masles legitimes descendans d
d’eulx,tantqu’	d ’ eulx , tant qu ’
ilyenauraaucuns,pourletempsadvenir	il y en aura aucuns , pour le temps advenir
,leschosesetseigneuriesquis’ensuivent..et	, les choses et seigneuries qui s ’ ensuivent . . et
etenaprèsdesclarées,c..’	et en après desclarées , c . . ’
’estassavoirlesconté,terreet	’ est assavoir les conté , terre et
etseigneuriedeGiensurLoire,leschasteaux,villes	et seigneurie de Gien sur Loire , les chasteaux , villes
,terres..etseigneuriesdeSaint	, terres . . et seigneuries de Saint
Maxent,Melle,Civray,	Maxent , Melle , Civray ,
,Chizetet	, Chizet et
etSaincteNeomaye,situezen	et Saincte Neomaye , situez en
nostrepaïsdePoictou,avecquestoutesetchascunes	nostre païs de Poictou , avecques toutes et chascunes
leursappartenances,appendencesetdeppendences,tantqu	leurs appartenances , appendences et deppendences , tant qu
qu’ilzsepeventcomporter	qu ’ ilz se pevent comporter
enlong.et	en long . et
etenlarge,avecles	et en large , avec les
fons,treffons,	fons , treffons ,
fruictz,proffiz,revenueset	fruictz , proffiz , revenues et
emolumens,tantencens,	emolumens , tant en cens ,
rentesd’argent,devin..,	rentes d ’ argent , de vin . . ,
degrainque	de grain que
d’autres	d ’ autres
choses,hommesetfemmesdecorps,	choses , hommes et femmes de corps ,
estangs,eaux,moulins,forestz	estangs , eaux , moulins , forestz
forestz,boys,prez,	forestz , boys , prez ,
dismes,champs,pastures,collacionsdebenefices	dismes , champs , pastures , collacions de benefices
,nominacionsd	, nominacions d
’officesquisontennostrecollacion	’ offices qui sont en nostre collacion
,fiez,arrierefiez,	, fiez , arrierefiez ,
haultejustice,basseet	haulte justice , basse et
moyenne,ettouzautres	moyenne , et touz autres
droizetseigneuriesque	droiz et seigneuries que
quenousavonsetavoirpovonsdedroitetde	que nous avons et avoir povons de droit et de
coustumeèsdiz	coustume èsdiz
contédeGien,	conté de Gien ,
,chasteaux,villesetterresdessusdictes,eten	, chasteaux , villes et terres dessus dictes , et en
enchascune.d’icelles,sans	en chascune . d ’ icelles , sans
riensenretenirànousneànozsuccesseurs	riens en retenir à nous ne à noz successeurs
successeurs,en	successeurs , en
quelquemaniereque	quelque maniere que
cesoit,exceptélesfoiz.	ce soit , excepté les foiz .
ethommaigesqu’iletses	et hommaiges qu ’ il et ses
successeurs.feraànousetauxnostres,ressortet	successeurs . fera à nous et aux nostres , ressort et
souveraineté,ensemblelesfoyethomage	souveraineté , ensemble les foy et homage
quinous	qui nous
sontdeuz	sont deuz
àcausedeschastel,terre.etseigneuriedePartenay	à cause des chastel , terre . et seigneurie de Partenay
Partenay,s’ilzsonttenuzde	Partenay , s ’ ilz sont tenuz de
denous,àcaused’aucunesdesdictes..places	de nous , à cause d ’ aucunes desdictes . . places
,terresetseigneuries	, terres et seigneuries
tantseulement.Pour	tant seulement . Pour
Pourtouteslesdictesconté	Pour toutes lesdictes conté
,terresetseigneuriesdessusdictesetchascuned	, terres et seigneuries dessus dictes et chascune d
’icellesparnousdonnées,baillées,cedées,	’ icelles par nous données , baillées , cedées ,
transportéesetdelaisséesànostreditfrereetcousin,	transportées et delaissées à nostre dit frere et cousin ,
,parlaformeetmaniere	, par la forme et maniere
queditest,	que dit est ,
avoir,tenirdoresnavantetpossidercomme	avoir , tenir doresnavant et possider comme
sonpropreheritaigeetdemaineà.tousjoursmais	son propre heritaige et demaine à . tousjours mais
perpetuelment;etdès	perpetuelment ; et dès
maintenantparla	maintenant par la
tradiciondecesdictespresentesl’enlaissonset	tradicion de ces dictes presentes l ’ en laissons et
faisonsvrayseigneur	faisons vray seigneur
seigneur,proprietaireetususfruitier,etnous	seigneur , proprietaire et ususfruitier , et nous
endesvestonsdutoutetrevestonsnostreditfrereet	en desvestons du tout et revestons nostre dit frere et
cousin,ses	cousin , ses
dizhoirsetsuccesseursmasleslegitimes	diz hoirs et successeurs masles legitimes
,descendansdesachar,etlesheritiers	, descendans de sa char , et les heritiers
heritiersmaslesdescendansd’eulxpourletempsadvenir..	heritiers masles descendans d ’ eulx pour le temps advenir . .
.Voulansetexpressementconsentansqu’il	. Voulans et expressement consentans qu ’ il
enaitetpuisseavoirincontinent	en ait et puisse avoir incontinent
,ouquantbonluisemblera	, ou quant bon lui semblera
prendreetapprehenderparluy,sesprocureurs	prendre et apprehender par luy , ses procureurs
oucommis,	ou commis ,
lapossessionactuelle,reelle	la possession actuelle , reelle
etcorporelle.Sidonnons	et corporelle . Si donnons
enmandement,	en mandement ,
parlateneurdecesdictespresentes..	par la teneur de ces dictes presentes . .
,ànosamez	, à nos amez
etfeaulxlesgenstenansnostre	et feaulx les gens tenans nostre
Parlement,lesgensdenozcomptes,lesgeneraulx	Parlement , les gens de noz comptes , les generaulx
generaulxconseillersparnous..ordonnezsur	generaulx conseillers par nous . . ordonnez sur
lefaitetgouvernement.detoutesnozfinances	le fait et gouvernement . de toutes noz finances
,lesballifsdeMontargis,deBerry	, les ballifs de Montargis , de Berry
,seneschaldePoictou,lestresorierssur	, seneschal de Poictou , les tresoriers sur
lefaitdenostre	le fait de nostre
nostredemaine,receveurgeneraldetoutesnosdictesfinances	nostre demaine , receveur general de toutes nos dictes finances
,etàtouz.noz	, et à touz . noz
autresofficiers,	autres officiers ,
justiciers,presenset	justiciers , presens et
advenir,àleurs	advenir , à leurs
lieuxtenansetcommis,	lieuxtenans et commis ,
etàchascund’eulx,ausquelx	et à chascun d ’ eulx , ausquelx
appartendra,quedenostredit	appartendra , que de nostre dit
ditdon,cession..ettransportlaissent	dit don , cession . . et transport laissent
,facentetseuffrent,chascun	, facent et seuffrent , chascun
endroitsoy	en droit soy
,nostredit.	, nostre dit .
.frereetcousin	. frere et cousin
,seshoirset	, ses hoirs et
successeursmasles,descendansdesacharparmariaige	successeurs masles , descendans de sa char par mariaige
,etlesheritiersmasles	, et les heritiers masles
descendanslegitimementd’eulxpourletemps	descendans legitimement d ’ eulx pour le temps
tempsadvenir,desdizcontédeGien,	temps advenir , des diz conté de Gien ,
chasteaux,villes,terresetseigneuriesdeSaint	chasteaux , villes , terres et seigneuries de Saint
SaintMaxent,Melle	Saint Maxent , Melle
,Civray,Chizec	, Civray , Chizec
ChizecetSaincte..Neomaye,ensembledetoutesetchascunesleurs	Chizec et Saincte . . Neomaye , ensemble de toutes et chascunes leurs
appartenances,appendencesetdeppendences,	appartenances , appendences et deppendences ,
joïr.etuserplainementetpaisiblement	joïr . et user plainement et paisiblement
,sansencelesperturberou	, sans en ce les perturber ou
ouempeschierenaucunemaniere;carainsinous	ou empeschier en aucune maniere ; car ainsi nous
plaistiletvoulons	plaist il et voulons
estrefait.Etsur	estre fait . Et sur
surceimposonssilenceperpetuelà	sur ce imposons silence perpetuel à
ànozadvocatetprocureur,etàtouznozautres	à noz advocat et procureur , et à touz noz autres
justiciersetofficiers,nonobstantquelzconquesedictz	justiciers et officiers , non obstant quelzconques edictz
edictzetordonnancesparnous	edictz et ordonnances par nous
ouaucunsdenozpredecesseursfaictes	ou aucuns de noz predecesseurs faictes
faictesde..non	faictes de . . non
desmembrer,vendre,donner,alieneroutransporter	desmembrer , vendre , donner , aliener ou transporter
nostredemaine;	nostre demaine ;
;lesquelles,auregartde	; lesquelles , au regart de
cestrenostrepresenteconcession,denostre	cestre nostre presente concession , de nostre
plainepuissanceetauctoritéroyal,nevoulonsavoir	plaine puissance et auctorité royal , ne voulons avoir
avoir.lieu,nesortirsoneffectaucunement	avoir . lieu , ne sortir son effect aucunement
,dons,pensions,provisionset	, dons , pensions , provisions et
biensfaizautresfoispar	biensfaiz autresfois par
nousfaizouàfaireànostredit	nous faiz ou à faire à nostre dit
frereetcousin,etquelxconquesautreschosesàl	frere et cousin , et quelxconques autres choses à l
l’execuciondecesdictespresentescontraires.	l ’ execucion de ces dictes presentes contraires .
Ausquelles,entesmoing	Ausquelles , en tesmoing
tesmoingdeveritéet	tesmoing de verité et
affinquecesoitchosefermeetestable	affin que ce soit chose ferme et estable
àtousjours,nousavonsfaitmettre	à tousjours , nous avons fait mettre
mettrenostreseelordonnéenl’	mettre nostre seel ordonné en l ’
absencedu	absence du
dugrant.Saufetreservéenautres	du grant . Sauf et reservé en autres
chosesnostredroitetl’autruy	choses nostre droit et l ’ autruy
autruyentoutes.DonnéàMontaulban,ou	autruy en toutes . Donné à Montaulban , ou
moys..defevrierl’andegracemil	moys . . de fevrier l ’ an de grace mil
milcccc.quaranteet	mil cccc . quarante et
deux,etdenostreregnelexxie.Ainsi	deux , et de nostre regne le xxie . Ainsi
Ainsisigné:Parleroyensongrantconseil	Ainsi signé : Par le roy en son grant conseil
,ouquel	, ou quel
monseigneurledaulphin..,lecontedelaMarche,	monseigneur le daulphin . . , le conte de la Marche ,
l’arcevesquedeVienne,l	l ’ arcevesque de Vienne , l
’evesquedeMagalonne,l’admiralet	’ evesque de Magalonne , l ’ admiral et
etplusieursautresestoient.J.delaLoere.	et plusieurs autres estoient . J . de la Loere .
