Charles,parlagracedeDieu	Charles , par la grace de Dieu
roydeFrance.Savoirfaisonsàtous,presens..	roy de France . Savoir faisons à tous , presens . .
etadvenir,nous	et advenir , nous
avoirreceul’	avoir receu l ’
’umblesupplicaciondeAlixandreduLeude	’ umble supplicacion de Alixandre du Leude
LeudeetJehanPichier,escuiers	Leude et Jehan Pichier , escuiers
,contenantquedeuxansaouenvironqueledit	, contenant que deux ans a ou environ que ledit
AlixandresetransportaàRomennostre	Alixandre se transporta à Rom en nostre
nostrepaysdePoictou,enl’	nostre pays de Poictou , en l ’
osteld..’	ostel d . . ’
’.ungnomméGibault	’ . ung nommé Gibault
,lequeltenoitvinàvendreauditlieu;en	, lequel tenoit vin à vendre audit lieu ; en
enlaquellemaisonestoientplusieursautrespersonnesetgensdevillaige	en laquelle maison estoient plusieurs autres personnes et gens de villaige
;lequelAlixandrevouloitaffermeretbailler	; lequel Alixandre vouloit affermer et bailler
àfermecertainesdismesestansenladicteparroisse	à ferme certaines dismes estans en ladicte parroisse
deRom,appartenansàlui,à.Jehanneet	de Rom , appartenans à lui , à . Jehanne et
MariedeLeude,sesseurs;etpareillement	Marie de Leude , ses seurs ; et pareillement
pareillementoudithostelestoit	pareillement oudit hostel estoit
auditlieudeRomungnomméJehanAudouyn,homme	audit lieu de Rom ung nommé Jehan Audouyn , homme
nonnoble,	non noble ,
,lequelavoitmisles	, lequel avoit mis les
lesdismesdel’arceprestreduditlieudeRomà	les dismes de l ’ arceprestre dudit lieu de Rom à
àpris,eteulxestantensembleainsi	à pris , et eulx estant ensemble ainsi
enladicte	en la dicte
maison,lesdizAlixandreetAudouyneurentparollescontencieuses	maison , lesdiz Alixandre et Audouyn eurent parolles contencieuses
d’unepiècedeterre,en	d ’ une pièce de terre , en
laquelleleditAlixandredisoitavoir	laquelle ledit Alixandre disoit avoir
avoirdroitdeprandre	avoir droit de prandre
prandredismes,	prandre dismes ,
etleditAudouyndisoitaucontraireetque[	et ledit Audouyn disoit au contraire et que [
la]dismedeladictepièce	la ] disme de ladicte pièce
deterreappertenoitauditarceprestre.AuquelAudouynleditAlixandre	de terre appertenoit audit arceprestre . Auquel Audouyn ledit Alixandre
distqu’ilmentoit,àquoy	dist qu ’ il mentoit , à quoy
quoyleditAudouynresponditmaisluimentoit	quoy ledit Audouyn respondit mais lui mentoit
.AprèslesquellesparollesleditAlixandreincontinent	. Après lesquelles parolles ledit Alixandre incontinent
tirasadagueeten..frappaleditAudouyn	tira sa dague et en . . frappa ledit Audouyn
parl’espolle;	par l ’ espolle ;
etincontinentqu’il..	et incontinent qu ’ il . .
[eut]ainsi	[ eut ] ainsi
frappéleditAudouyn	frappé ledit Audouyn
,quinzeouseize..compaignons,qui	, quinze ou seize . . compaignons , qui
illecestoientàla..taverne	illec estoient à la . . taverne
taverne,prindrentleditAlixandrede	taverne , prindrent ledit Alixandre de
de.leurauctoritéprivée,sansauctoritédejustice	de . leur auctorité privée , sans auctorité de justice
etsansaucun	et sans aucun
aucunsergentnecommandement	aucun sergent ne commandement
commandementd’aucunjugeayantà	commandement d ’ aucun juge ayant à
cepuissance,et	ce puissance , et
leditAlixandrelièrentetluiostèrent	ledit Alixandre lièrent et lui ostèrent
sadague,etaprèslemenèrentenprisonau	sa dague , et après le menèrent en prison au
aulieudeCouhé,ès	au lieu de Couhé , ès
quelles.prisonsildemouradepuisle	quelles . prisons il demoura depuis le
dimenchejusquesaujeudiensuivant.Et.	dimenche jusques au jeudi ensuivant . Et .
aprèsquelesdessusdiz..eurentainsimis	après que les dessus diz . . eurent ainsi mis
etmenéleditAlixandreenprison	et mené le dit Alixandre en prison
prison,ilzs’enretournèrentenl’	prison , ilz s ’ en retournèrent en l ’
osteld’unnomméGentet,auquelavoitvin	ostel d ’ un nommé Gentet , auquel avoit vin
àvendre,	à vendre ,
,et..despendirentladague	, et . . despendirent la dague
duditAlixandre.Etdepuis	dudit Alixandre . Et depuis
,c’estassavoirle..viiimejour	, c ’ est assavoir le . . viii me jour
dejuingderrenierementpassé,lesdizAlixandreetJehan	de juing derrenierement passé , les diz Alixandre et Jehan
Picher,maridesaseur,	Picher , mari de sa seur ,
,supplians,estansaulieudeRochePicher,	, supplians , estans au lieu de Roche Picher ,
enlamaisonduditJehanPicher,	en la maison dudit Jehan Picher ,
setransportèrentaulieude..laFeole,pour	se transportèrent au lieu de . . la Feole , pour
affermerleursmestaieries,etd’	affermer leurs mestaieries , et d ’
’ilecs’enalèrentsoupperauPetit	’ ilec s ’ en alèrent soupper au Petit
boysenl’osteld’ungnommé	boys en l ’ ostel d ’ ung nommé
Biroil,etaprèscequ	Biroil , et après ce qu
’ilzeurent	’ ilz eurent
eurentsouppé,separtirentduditlieu	eurent souppé , se partirent dudit lieu
lieupourallercoucherau	lieu pour aller coucher au
auMimerez,[et]rencontrerentenleur	au Mimerez ,[ et ] rencontrerent en leur
cheminEstienneParisetungnomméCourtois,lesquelz	chemin Estienne Paris et ung nommé Courtois , lesquelz
lessaluèrent;et..quantilz	les saluèrent ; et . . quant ilz
furentpassezoultrelesdizsupplians,	furent passez oultre lesdiz supplians ,
,leditAlixandreeutmemoirequec’estoitungd	, ledit Alixandre eut memoire que c ’ estoit ung d
’iceulxquil’avoient	’ iceulx qui l ’ avoient
mennéenprison,etdistauditJehanPicher,	menné en prison , et dist audit Jehan Picher ,
sonfrère,tellesparolles:«Veezlàdeceulx	son frère , telles parolles :« Veez là de ceulx
quifurentàmoymenerenprison.Je	qui furent à moy mener en prison . Je
Jevueilretourner..pour	Je vueil retourner . . pour
luidonnerung	lui donner ung
soufflet.»EtlorsleditPicherdistaudit	soufflet .» Et lors ledit Picher dist audit
auditAlixandrequ’	audit Alixandre qu ’
il..leprioitqu	il . . le prioit qu
’ilnelui	’ il ne lui
feustfaitchosepourquoyilzfeussentendangierde	feust fait chose pour quoy ilz feussent en dangier de
justice.AquoyleditAlixandrerespondyquenon	justice . A quoy ledit Alixandre respondy que non
nonferoitil	non feroit il
,etincontinentlesparollesdictes	, et incontinent les parolles dictes
,ilzs’enretournèrent	, ilz s ’ en retournèrent
retournèrentetalèrentaprèsleditParis;	retournèrent et alèrent après ledit Paris ;
lequel,quantilvitlesdizsuppliansretournercontre	lequel , quant il vit lesdiz supplians retourner contre
lui,commençaàfouyràtravers	lui , commença à fouyr à travers
buisson;lequellesdizsupplians	buisson ; lequel lesdiz supplians
cerchièrent,etquantilzl’eurenttrouvé,	cerchièrent , et quant ilz l ’ eurent trouvé ,
mirentpié	mirent pié
piéàterreettirèrentleursespées,etlors	pié à terre et tirèrent leurs espées , et lors
leditPichierlefrappadeux..cops	ledit Pichier le frappa deux . . cops
dupommeaude.sonespéesurlesespaules,et	du pommeau de . son espée sur les espaules , et
leditAlixandrele	ledit Alixandre le
cuidafrapperdupommeaudesonespéesur	cuida frapper du pommeau de son espée sur
levisaige;etainsi	le visaige ; et ainsi
ainsiqueleditParistournalevisaige,ledit	ainsi que le dit Paris tourna le visaige , ledit
Alixandrel’	Alixandre l ’
ataingnyet	ataingny et
lefrappasurlateste	le frappa sur la teste
ungcoptant..seulement,etatantsedepartirent.	ung cop tant . . seulement , et atant se departirent .
Ets’enalaledit	Et s ’ en ala ledit
Parisàsa	Paris à sa
maison,etfut..	maison , et fut . .
.ledimencheensuivantàlamesse.Etce	. le dimenche ensuivant à la messe . Et ce
fait,les	fait , les
lesdiz.supplianss’enalèrent	les diz . supplians s ’ en alèrent
couchierauditlieudeMimerez.	couchier audit lieu de Mimerez .
LequelParisadepuisvescu	Lequel Paris a depuis vescu
xi.jours	xi . jours
,etlexii	, et le xii
°jourensuivant,	° jour ensuivant ,
pardeffaultdegouvernement,paraccident	par deffault de gouvernement , par accident
accidentd’autremaladiequ	accident d ’ autre maladie qu
’ilzsemeurent(	’ ilz se meurent (
(sic),ouautrement,	( sic ), ou autrement ,
aladevieà	ala de vie à
trespassement.Al’occasion	trespassement . A l ’ occasion
duquelcas,lesdizsupplians,doubtansrigueur	duquel cas , les diz supplians , doubtans rigueur
dejustice,sesontabsentezdupayset	de justice , se sont absentez du pays et
n’yoseroientjamaisretourner,se	n ’ y oseroient jamais retourner , se
nostregraceetmisericorde	nostre grace et misericorde
neleurestoientsurceimparties	ne leur estoient sur ce imparties
,humblementrequerans	, humblement requerans
que,attenduceque	que , attendu ce que
queditest,etque	que dit est , et que
lesdizsupplianssontgensdebonfameet	les diz supplians sont gens de bon fame et
renomméeet.honneste	renommée et . honneste
conversacion,nonactains	conversacion , non actains
ouconvaincusd’	ou convaincus d ’
aucunautre..vilain	aucun autre . . vilain
cas,blasmeoureproche,et	cas , blasme ou reproche , et
qu’ilzn’avoientpointentencionde	qu ’ ilz n ’ avoient point entencion de
blecer,mutiler	blecer , mutiler
netuerleditParis,etnele	ne tuer ledit Paris , et ne le
frappèrentpointd’	frappèrent point d ’
estocnedetailledeleursespées,qu	estoc ne de taille de leurs espées , qu
qu’ilalonguementvescudepuis	qu ’ il a longuement vescu depuis
ladictebaterie,etluipeutestresoudainementsourvenueaucune	ladicte baterie , et lui peut estre soudainement sourvenue aucune
maladie,de..laquelleilpeut	maladie , de . . laquelle il peut
estrealezdevieàtrespassement,ilnous	estre alez de vie à trespassement , il nous
plaiseleurimpartiricelles.Pourquoy	plaise leur impartir icelles . Pour quoy
quoynous,.attenducequedit	quoy nous , . attendu ce que dit
dit..est,voulansmisericordepreferer	dit . . est , voulans misericorde preferer
àrigueurdejustice,.ausdizsuppliansouditcas	à rigueur de justice , . aus diz supplians oudit cas
casavonsremis	cas avons remis
,quictéetpardonné,etc	, quicté et pardonné , etc
etc.,satisfactionfaicteàpartiecivilementtant	etc ., satisfaction faicte à partie civilement tant
tantseulement,etc.Si..donnonsenmandement	tant seulement , etc . Si . . donnons en mandement
parcespresentes..aux	par ces presentes . . aux
seneschaulxdePoictouetdeXanctongeet	seneschaulx de Poictou et de Xanctonge et
àtousnozautresjusticiers,	à tous noz autres justiciers ,
,etc.DonnéàBleré,oumoys	, etc . Donné à Bleré , ou moys
de..juilletl’	de . . juillet l ’
’.andegracemilquatrecensxlviii,et	’ . an de grace mil quatre cens xlviii , et
denostrerègnelexxvime	de nostre règne le xxvi me
.Ainsisigné:Parleroy	. Ainsi signé : Par le roy
,àlarelacionduconseil.E.	, à la relacion du conseil . E .
Froment.—	Froment .—
Visa.Contentor.E	Visa . Contentor . E
.Froment.	. Froment .
