Loys,parlagracedeDieuroyde	Loys , par la grace de Dieu roy de
France.Savoir,etc.,	France . Savoir , etc .,
nous,etc..	nous , etc . .
.,desparensetamischarnelzde	., des parens et amis charnelz de
deThomasSurye,hommedelabour,demorantou	de Thomas Surye , homme de labour , demorant ou
vicomtédeCastelleraud	vicomté de Castelleraud
,contenant	, contenant
quelelundi	que le lundi
lundixxxixe..jour	lundi xxxixe . . jour
dejuilletderrenierpassé.,luiestantcommissaire	de juillet derrenier passé . , lui estant commissaire
commissairedeparnousetausside	commissaire de par nous et aussi de
parnostretrèschierettrèsamé	par nostre très chier et très amé
amécousinleduc	amé cousin le duc
deCalabre,conteduMaineetviconte	de Calabre , conte du Maine et viconte
deChastelleraud,à..traicter,regir	de Chastelleraud , à . . traicter , regir
etgouvernerlesdommainesetheritaigesavecles	et gouverner les dommaines et heritaiges avec les
fruizd’iceulxappartenansàMeryBloteau,	fruiz d ’ iceulx appartenans à Mery Bloteau ,
,GrandJeanBloteau,JehanBloteaule	, Grand Jean Bloteau , Jehan Bloteau le
clerc.et	clerc . et
plusieursautres,etestanscommissairesaussi	plusieurs autres , et estans commissaires aussi
aussi,avecleditThomasSuyre,JehanGiraudeauet	aussi , avec ledit Thomas Suyre , Jehan Giraudeau et
JehanDegenes,icellescommissions	Jehan Degenes , icelles commissions
commissionsmisesetapposéessurlesdizheritaigestant	commissions mises et apposées sur lesdiz heritaiges tant
àlarequestedemaistreJehanLucasqueautres,	à la requeste de maistre Jehan Lucas que autres ,
,icelluyThomas	, icelluy Thomas
Suyre,parvertudesdites	Suyre , par vertu desdites
commissionsetpourlesmettreàexecutiondepar	commissions et pour les mettre à execution de par
noussetransportaenetsurune	nous se transporta en et sur une
unepièce.de	une pièce . de
terreestantprèsdeBoisson	terre estant près de Boisson
Boissonen.laparroissed’AvailleauditcontédeChastelleraud	Boisson en . la parroisse d ’ Availle audit conté de Chastelleraud
Chastelleraud,appartenanticelleterreauditMeryBloteau	Chastelleraud , appartenant icelle terre audit Mery Bloteau
,.laquelle	, . laquelle
estoitseméeenavoine	estoit semée en avoine
,enentencion	, en entencion
entenciondeprendreetenleverlesgerbesqui	entencion de prendre et en lever les gerbes qui
quiestoientenladiteterre,commecommissairesusdit,et	qui estoient en ladite terre , comme commissaire susdit , et
pourcefaireetluy	pour ce faire et luy
luyaideravoitmenéavecluyJehanetGuillaume	luy aider avoit mené avec luy Jehan et Guillaume
Suyre,ses	Suyre , ses
enffans,quiavoientmenéesleurs	enffans , qui avoient menées leurs
charretespouramenerlesditesgerbes.Etquantledit	charretes pour amener lesdites gerbes . Et quant ledit
leditThomaset.sesdizenffansfurentarrivezenladitepièce	ledit Thomas et . sesdiz enffans furent arrivez en ladite pièce
deterre,trouvèrentleditMeryBloteau,	de terre , trouvèrent ledit Mery Bloteau ,
quiavoitunggros	qui avoit ung gros
paloupaubort	pal ou paubort
paubortenlamain.LequelditincontinentauditThomaset	paubort en la main . Lequel dit incontinent audit Thomas et
etàsesdizenffansqu..’	et à sesdiz enffans qu . . ’
ilzneemmeneroient	ilz ne emmeneroient
pointlesditesgerbes.AquoyleditThomasrespondit	point lesdites gerbes . A quoy ledit Thomas respondit
quesiferoit	que si feroit
.Etceveant,leditGuillaumeSurye,	. Et ce veant , ledit Guillaume Surye ,
filzduditThomas,doubtantqueleditBloteaulesvoulsist..	filz dudit Thomas , doubtant que ledit Bloteau les voulsist . .
frapperduditpaubort,luy.osta	frapper dudit paubort , luy . osta
icelluypaubort	icelluy paubort
sansl’en	sans l ’ en
enfrapperneluyfairemal..	en frapper ne luy faire mal . .
.Etcefait,ledit	. Et ce fait , ledit
leditThomasetsesdiz..enffanschargèrentlesditesgerbesd’	ledit Thomas et sesdiz . . enffans chargèrent lesdites gerbes d ’
’avoinejusquesaunombrede	’ avoine jusques au nombre de
deseptoudehuit;et.ence	de sept ou de huit ; et . en ce
cefaisant,	ce faisant ,
survintillecenladitepiècedeterrefeu	survint illec en ladite pièce de terre feu
JehanPatarin,..quidemandaauditThomas	Jehan Patarin , . . qui demanda audit Thomas
Thomasetàsesdizenffansquec’	Thomas et à sesdiz enffans que c ’
estoitqu’ilzvouloientfaire.Etlorsledit	estoit qu ’ ilz vouloient faire . Et lors ledit
Thomasresponditquivouloitenmenerlesditesgerbes	Thomas respondit qui vouloit enmener lesdites gerbes
etqu’ilestoit	et qu ’ il estoit
commissairede	commissaire de
parnouset	par nous et
deparnostreditcousinduMaineàcefaire	de par nostredit cousin du Maine à ce faire
faire,ayansdeceexpresses	faire , ayans de ce expresses
commissions.Et.lorsleditJehanPatarincommença	commissions . Et . lors ledit Jehan Patarin commença
àjurerparlesangNostre-Seigneurquenon	à jurer par le sang Nostre - Seigneur que non
feroitetqu’	feroit et qu ’
iln’enauroitnegerbenedemye	il n ’ en auroit ne gerbe ne demye
.Aquoyledit	. A quoy ledit
Thomasditquesiferoit.	Thomas dit que si feroit .
.Et.aprèsce,icelluifeuJehanPatarindemanda	. Et . après ce , icellui feu Jehan Patarin demanda
sadixme,	sa dixme ,
etleditThomasresponditqueà	et ledit Thomas respondit que à
sadixmeilnemettoitpointd’empeschement,	sa dixme il ne mettoit point d ’ empeschement ,
,maisqueencores	, mais que encores
iln’avoit	il n ’ avoit
prinsguèresdegerbesqueenvironseptou	prins guères de gerbes que environ sept ou
huit.Etenceconflitet	huit . Et en ce conflit et
débat,leditJehanPatarin.seprint	débat , ledit Jehan Patarin . se print
àl’esguillonde	à l ’ esguillon de
dequoyleditThomastouschoit	de quoy ledit Thomas touschoit
touschoitsesbeufz,enentenciondel’empescherde	touschoit ses beufz , en entencion de l ’ empescher de
enmenerlesditesgerbes;etceveant.	enmener lesdites gerbes ; et ce veant .
,leditThomas.tiraung	, ledit Thomas . tira ung
ungcousteauqu’ilavoit,quiestoitenviron	ung cousteau qu ’ il avoit , qui estoit environ
dedeuxpiez	de deux piez
,etenbailla	, et en bailla
duplatauditfeuJehanPatarindeuxcops	du plat audit feu Jehan Patarin deux cops
surlesépaulles,	sur les épaulles ,
sansleblecieretluyfistlaisserleditesguillon	sans le blecier et luy fist laisser ledit esguillon
;etlorssedépartirentdeensemble	; et lors se départirent de ensemble
,.sansblecierl	, . sans blecier l
’unl’autre.Etincontinent	’ un l ’ autre . Et incontinent
incontinents’enretourna	incontinent s ’ en retourna
leditThomasavecsesdizenffanscharger	ledit Thomas avec sesdiz enffans charger
chargerlesditesgerbes	charger lesdites gerbes
enladitepièce.deterre.Et	en ladite pièce . de terre . Et
aucuntempsaprès,ainsiqu’ilsles	aucun temps après , ainsi qu ’ ils les
chargoient.,leditfeuJehanPatarinretournade	chargoient . , ledit feu Jehan Patarin retourna de
rechiefsureulx,	rechief sur eulx ,
ens’adreçantauditGuillaumeSuyre,fils.	en s ’ adreçant audit Guillaume Suyre , fils .
duditThomas,auquelilbailladu	dudit Thomas , auquel il bailla du
poingsur	poing sur
lateste,tellementqu’illuyfisttrès	la teste , tellement qu ’ il luy fist très
fortplesserlecoul	fort plesser le coul
;etceveant,leditGuillaume	; et ce veant , ledit Guillaume
,quiestoit	, qui estoit
estoit.seuletàpartdesesdiz	estoit . seul et à part de sesdiz
pèreetfrère	père et frère
,seprint	, se print
printàcrierendisant:«Aydez	print à crier en disant :« Aydez
moy,aydezmoy	moy , aydez moy
!carilm	! car il m
’afolle.».Et	’ afolle . ». Et
incontinent..leditJehan	incontinent . . ledit Jehan
JehanSuyre,frèreduditGuillaumeetfils	Jehan Suyre , frère dudit Guillaume et fils
duditThomas,luyestantenla	dudit Thomas , luy estant en la
lacharrèteoùilchargeoitlesdites..gerbes	la charrète où il chargeoit lesdites . . gerbes
avecsondit.	avec sondit .
père,sorty..àterredeladitecharrète	père , sorty . . à terre de ladite charrète
charrètepouralersecourirsonditfrère.Ettantostqueicelluy	charrète pour aler secourir sondit frère . Et tantost que icelluy
JehanSuyrefutdescenduàterreet	Jehan Suyre fut descendu à terre et
queleditPatarinlevit,seprintà	que ledit Patarin le vit , se print à
fouyr,etlorsleditThomas.etsesdizenffans	fouyr , et lors ledit Thomas . et sesdiz enffans
enffanscommencèrentàaleraprès,	enffans commencèrent à aler après ,
etmesmementledit.	et mesmement ledit .
Thomas,quipassa	Thomas , qui passa
sesdizenffans,etlesquelzne	sesdiz enffans , et lesquelz ne
lesuyvirentpasjusquesàlafin.	le suyvirent pas jusques à la fin .
MaisainsiqueleditThomassuyvoitleditfeu..	Mais ainsi que ledit Thomas suyvoit ledit feu . .
Patarin,icelluyfeuJehanPatarin	Patarin , icelluy feu Jehan Patarin
cheutpartroisfoizà	cheut par trois foiz à
terreetàladerrenièrefoizsaulta	terre et à la derrenière foiz saulta
ungpetitmur,où	ung petit mur , où
ilyavoitdubuisson,et	il y avoit du buisson , et
encefaisant	en ce faisant
cheutàterre;ettantostledit.	cheut à terre ; et tantost ledit .
Thomasalaàluy	Thomas ala à luy
luyetluydonnaduplatdesondit	luy et luy donna du plat de sondit
cousteausur	cousteau sur
surlateste	sur la teste
deuxoutrois	deux ou trois
cops,sansluifaireaucunebleceureneeffusion	cops , sans lui faire aucune bleceure ne effusion
desang,etle	de sang , et le
laissailecenlaplace.MaisicelluiPatarin	laissa ilec en la place . Mais icellui Patarin
ensaultantleditmurserompitlajambe,et	en saultant ledit mur se rompit la jambe , et
tellementque,à	tellement que , à
àl’occasiondeladiteromptureet	à l ’ occasion de ladite rompture et
decequ’ils’estoit	de ce qu ’ il s ’ estoit
eschauffé,etaussiquec’estoit	eschauffé , et aussi que c ’ estoit
deverslesoir,àvoléed’..	devers le soir , à volée d ’ . .
assee,quepar	assee , que par
faultedecequ’ilnefutpenséni	faulte de ce qu ’ il ne fut pensé ni
nihabilléetdebongouvernement,	ni habillé et de bon gouvernement ,
ouautrement,	ou autrement ,
,ilala,	, il ala ,
deuxoutroysjoursaprès,	deux ou troys jours après ,
devieàtrespassement.Al’	de vie à trespassement . A l ’
occasionduquelcas,leditThomasdoubtant	occasion duquel cas , ledit Thomas doubtant
rigueurdejustice,s	rigueur de justice , s
s’estabsenté	s ’ est absenté
dupaysoumis.enfranchise	du pays ou mis . en franchise
,etn’oseroitjamaisretournerniseurementconverser	, et n ’ oseroit jamais retourner ni seurement converser
aupays,..senozgraceetmisericorde	au pays , . . se noz grace et misericorde
neluyestoient	ne luy estoient
surceimparties,humblementrequerantque,attenduque	sur ce imparties , humblement requerant que , attendu que
queledit..Thomasestoitcommissairedeparnousàregir	que ledit . . Thomas estoit commissaire de par nous à regir
etgouvernerlesfruizdeladiteterre	et gouverner les fruiz de ladite terre
etquecequ’ilenfistestoit	et que ce qu ’ il en fist estoit
pourgardernostre	pour garder nostre
auctoritéetcelledenostreditcousinet	auctorité et celle de nostre dit cousin et
etenexcerçantjustice,etque	et en excerçant justice , et que
queleditfeuPatarinfeustagresseurdefait	que ledit feu Patarin feust agresseur de fait
etdeparolle,etn’	et de parolle , et n ’
yeutdela	y eut de la
partduditThomasaucunemutilacionnieffusionde..sang	part dudit Thomas aucune mutilacion ni effusion de . . sang
,parquoyestvraysemblable	, par quoy est vray semblable
semblableàpresumerquepluspar	semblable à presumer que plus par
lemoyendeladiterompturedejambeetpar	le moyen de ladite rompture de jambe et par
deffautdestrepenséetaussiqu’il.demouralonguement	deffaut destre pensé et aussi qu ’ il . demoura longuement
sur..laplaceetde	sur . . la place et de
eschaufoisonicelluifeuPatarin	eschaufoison icellui feu Patarin
aladevieà	ala de vie à
trespas,quepourlesdizcopzqueluybaillaledit	trespas , que pour lesdiz copz que luy bailla ledit
leditThomas,et	ledit Thomas , et
queenautre	que en autre
casicelluiThomasesttrèsfamé.etrenommé,	cas icellui Thomas est très famé . et renommé ,
ilnousplaiseluyimpartiricelles	il nous plaise luy impartir icelles
.Pourquoy	. Pour quoy
nous,ceschosesconsidérées,etc	nous , ces choses considérées , etc
.,auditThomasSuyreavons	., audit Thomas Suyre avons
quicté,remis	quicté , remis
remisetpardonné	remis et pardonné
,etc.,avec	, etc ., avec
toutepeine,amendeetoffense,etc	toute peine , amende et offense , etc
.Sidonnonsenmandement,par	. Si donnons en mandement , par
cesditesprésentes,ànostre	cesdites présentes , à nostre
seneschaldePoictouetà.tous	seneschal de Poictou et à . tous
nozjusticiers,	noz justiciers ,
etc.,que	etc ., que
leditThomasSuyredenoz	ledit Thomas Suyre de noz
presensgrace,quictance	presens grace , quictance
quictance,remission.etpardon,facent	quictance , remission . et pardon , facent
,seuffrentet	, seuffrent et
laissentjoïr,etc.DonnéàTours,	laissent joïr , etc . Donné à Tours ,
,oumoysd’aoust,l	, ou moys d ’ aoust , l
’andegracemiliiiic	’ an de grace mil iiiic
lxxvi,.etdenostrerègnelexvime,	lxxvi , . et de nostre règne le xvime ,
soubznostreseelordonné	soubz nostre seel ordonné
enl’absence	en l ’ absence
absencedugrant.Ainsisigné:ParleConseil.	absence du grant . Ainsi signé : Par le Conseil .
.JaPicart.—Visa.Contentor.J.	. Ja Picart .— Visa . Contentor . J .
