Charles,etc.Savoirfaisons	Charles , etc . Savoir faisons
faisons,etc.nous..	faisons , etc . nous . .
avoirreceul’umble	avoir receu l ’ umble
supplicaciondeFrançoisdeMontcatin,natifde	supplicacion de François de Montcatin , natif de
MontcatinenToscanne,capitaine	Montcatin en Toscanne , capitaine
capitainedelaRochesurYonpournostretrèschieret	capitaine de la Roche sur Yon pour nostre très chier et
ettrèsaméfrereleroydeSicille,duc	et très amé frere le roy de Sicille , duc
ducd’Anjou,contenantque,ung	duc d ’ Anjou , contenant que , ung
anaprèsquenostreditfrereleremisten	an après que nostre dit frere le remist en
sonservice,ilseaccointade	son service , il se accointa de
son..confesseur,	son . . confesseur ,
par.lequelilfistdireànostreditfrerequ	par . lequel il fist dire à nostre dit frere qu
’ilsavoitmanieredefaireargent	’ il savoit maniere de faire argent
d’arquemye,etqu’	d ’ arquemye , et qu ’
ilferoitmerveillesdeybesoingnerquiluivouldroitbailler	il feroit merveilles de y besoingner qui lui vouldroit bailler
baillerplacepourcefaire.Aquoy	bailler place pour ce faire . A quoy
,sursondonnéà	, sur son donné à
àentendre,nostreditfrereacquiessa.etluibaillala	à entendre , nostre dit frere acquiessa . et lui bailla la
capitaineriedeladicteRochesurYon,et,	capitainerie de la dicte Roche sur Yon , et ,
,enlapresencedenostredit	, en la presence de nostre dit
frere,en	frere , en
enlavilled’	en la ville d ’
Angiers,pour	Angiers , pour
acomplircequ’il	acomplir ce qu ’ il
avoitpromisdudit	avoit promis dudit
duditargentd’arquemye,il	dudit argent d ’ arquemye , il
printunglingotd’argent,lemisten	print ung lingot d ’ argent , le mist en
sonpongnetbienàlamoitié,puisrebrassases	son pongnet bien à la moitié , puis rebrassa ses
manchesdesa..robe,etce	manches de sa . . robe , et ce
cefaitletiraentre.deux	ce fait le tira entre . deux
doiz,lelaissa	doiz , le laissa
cheoirenungcroisetàfondreargentetmistung	cheoir en ung croiset à fondre argent et mist ung
charbondessus,	charbon dessus ,
,en..maniereque	, en . . maniere que
nostreditfrerenes’	nostre dit frere ne s ’
enapparceustpoint.	en apparceust point .
Etainsiparplusieurs..foizenaabusé,	Et ainsi par plusieurs . . foiz en a abusé ,
,etluiportasonfaitetconduiteenversnostre	, et lui porta son fait et conduite envers nostre
ditfrereleconfesseur,l’aumosnieret	dit frere le confesseur , l ’ aumosnier et
ungsurnomméCotignon,soubzumbredeceque	ung surnommé Cotignon , soubz umbre de ce que
queleditsuppliantleurpromettoitque,sesondit	que le dit suppliant leur promettoit que , se son dit
faitaloitbien	fait aloit bien
bien,qu’illeurmonstreroitet	bien , qu ’ il leur monstreroit et
feroitquelque	feroit quelque
biende..lascience	bien de . . la science
deladicte	de la dicte
arquemye.Etdepuis,c’estassavoirenviron	arquemye . Et depuis , c ’ est assavoir environ
laveilledelaConceptionde	la veille de la Conception de
NostreDamemilcccc.xliiii,	Nostre Dame mil cccc . xliiii ,
,arrivaauditlieudelaRoche	, arriva audit lieu de la Roche
surYonGeuffroy	sur Yon Geuffroy
LeFeron	Le Feron
,etvint	, et vint
denoncier..audit	denoncier . . audit
auditsuppliantsavenueungnommé	audit suppliant sa venue ung nommé
nomméFrançoisByecte.Laquellechosevenueàsa	nommé François Byecte . La quelle chose venue à sa
congnoissance,soubz	congnoissance , soubz
soubzumbrede	soubz umbre de
cequeunefemmenomméeJehanneLeuvronneluiavoit	ce que une femme nommée Jehanne Leuvronne lui avoit
avoitmandéqueleditGeuffroylui	avoit mandé que le dit Geuffroy lui
luiavoitdemandéoù	lui avoit demandé où
estoitlejardinduchastel,etqu	estoit le jardin du chastel , et qu
’ilsedoubtoitqu’ilvoulsist	’ il se doubtoit qu ’ il voulsist
àcestecausefairequelquechose	à ceste cause faire quelque chose
contrelui	contre lui
,veuqueautresfoizleditFeronavoitesté	, veu que autresfoiz le dit Feron avoit esté
causede..saprisonàNantes,icellui	cause de . . sa prison à Nantes , icellui
suppliantarresta	suppliant arresta
arrestaleditFerronou	arresta le dit Ferron ou
chastelduditlieudelaRochesur	chastel du dit lieu de la Roche sur
Yon,et,	Yon , et ,
environdeuxheuresaprès,	environ deux heures après ,
envoiaquerirparungdesesvarletzlaboistedudit	envoia querir par ung de ses varletz la boiste dudit
Ferronenl’ostellerieoùil	Ferron en l ’ ostellerie où il
estoitlogiéenla	estoit logié en la
ville.Et..quantil	ville . Et . . quant il
illatint,lamistenung	il la tint , la mist en ung
ungcoffreen	ung coffre en
lamaison	la maison
neufvequ	neufve qu
’ilafaitfaire	’ il a fait faire
faireouditchastel.Ouquellelendemainvint	faire ou dit chastel . Ouquel le lendemain vint
JaquetChabot,lequelennortaleditsuppliant	Jaquet Chabot , lequel ennorta le dit suppliant
defairemourirleditGeuffroy,àquoyil	de faire mourir le dit Geuffroy , à quoy il
ilnesevoultconsentir.Etaprès	il ne se voult consentir . Et après
entrerentenparoledela	entrerent en parole de la
boisteduditGeuffroy,laquelle	boiste dudit Geuffroy , la quelle
futactainteduditcoffre	fut actainte du dit coffre
,etl’ouvryle	, et l ’ ouvry le
leditChabot,enlapresenceduditsuppliant	le dit Chabot , en la presence dudit suppliant
suppliant,eteulxdeux	suppliant , et eulx deux
deuxvisiterentleslettresquiestoientenla	deux visiterent les lettres qui estoient en la
dicteboiste,etentrelesautres	dicte boiste , et entre les autres
trouverentungblancsignédenostre	trouverent ung blanc signé de nostre
nostreaméetfealchevalier,conseilleretchambellan,le	nostre amé et feal chevalier , conseiller et chambellan , le
lesire[de]Coictivy,admiral.de	le sire [ de ] Coictivy , admiral . de
France.Etdistlors..leditChabotaudit	France . Et dist lors . . le dit Chabot audit
suppliantque,s’ilvouloit,	suppliant que , s ’ il vouloit ,
queonjoueroitbiendeungtourauditFerron	que on joueroit bien de ung tour audit Ferron
,oùilaroit	, où il aroit
grantdommaige.Aquoyle	grant dommaige . A quoy le
ditsuppliantrespondyqu’ilestoitcontent	dit suppliant respondy qu ’ il estoit content
etqu’ilneluichaloitqueonlui	et qu ’ il ne lui chaloit que on lui
fist,maisqu’ilne	fist , mais qu ’ il ne
mourust.EtadoncleditChabotfistunefaulse	mourust . Et adonc le dit Chabot fist une faulse
lettre,de	lettre , de
delaquelleleditsuppliantfitemplirle..ditblanc	de laquelle le dit suppliant fit emplir le . . dit blanc
,etfutmisoufonsdeladicte	, et fut mis ou fons de la dicte
boiste,laquelleleditChabotfistreporterenvelopée	boiste , la quelle le dit Chabot fist reporter envelopée
envelopéeenungmanteauenlaville.Ettantostaprès	envelopée en ung manteau en la ville . Et tantost après
aprèslarenvoya	après la renvoya
,parsonpage,refermée,.audit	, par son page , refermée , . audit
suppliant,quila	suppliant , qui la
laremistensonditcoffre.Et	la remist en son dit coffre . Et
lelandemainparleconseildudit	le landemain par le conseil dudit
duditChabot,fisticelluysuppliantvenirdeversluiou	dudit Chabot , fist icelluy suppliant venir devers lui ou
chastellejuge,	chastel le juge ,
,l’advocatfiscal	, l ’ advocat fiscal
,leprocureur	, le procureur
,legreffier.duditjugeetplusieursautres	, le greffier . dudit juge et plusieurs autres
desplusnotablesde	des plus notables de
ladicteville,etenleur	la dicte ville , et en leur
leurpresencefistvenirleditFerron,	leur presence fist venir le dit Ferron ,
luifistapporterladicteboiste,luidemanda.	lui fist apporter la dicte boiste , lui demanda .
.sec’estoit	. se c ’ estoit
lasienne;lequelresponditque	la sienne ; lequel respondit que
queoyl.Etlorsluiendemandalaclef	que oyl . Et lors lui en demanda la clef
,laquellelui	, laquelle lui
lui..futbailléeparungdesvarletzdudit	lui . . fut baillée par ung des varletz dudit
Ferron.	Ferron .
Lequel,cefait,ilfistretraire	Lequel , ce fait , il fist retraire
,et,presenslesdessusdiz,ouvryla	, et , presens les dessus diz , ouvry la
dicteboeste,leutetfistlireleslettresqui	dicte boeste , leut et fist lire les lettres qui
estoientdedans,et,entre	estoient dedans , et , entre
entrelesautres,	entre les autres ,
cellequiavoitesté	celle qui avoit esté
estéainsifaulsementescripteouditblanc;laquelle	esté ainsi faulsement escripte oudit blanc ; laquelle
laquellelettre,	laquelle lettre ,
pourlamauvaistiécontenuededans,chascundesdessusdiz	pour la mauvaistié contenue dedans , chascun des dessus diz
leurentenblasmanttrèsfortleditFerron	leurent en blasmant très fort le dit Ferron
Ferrondeporterteleslettres.Nonobstanttoutes	Ferron de porter teles lettres . Non obstant toutes
touteslesquelleschoses,le	toutes les quelles choses , le
ditsuppliantadetenuleditFerronprisonnier	dit suppliant a detenu le dit Ferron prisonnier
,etdeluia	, et de lui a
euunzecensescuzd..’or,une	eu unze cens escuz d . . ’ or , une
douzainedetassesd’argentdupoixde	douzaine de tasses d ’ argent du poix de
dexxiiii.marcset	de xxiiii . marcs et
demy,drapdevelours,avecquesdix	demy , drap de velours , avecques dix
dixneuffrancscinqsolzmoinsquiestoientenla	dix neuf francs cinq solz moins qui estoient en la
boesteduditFerron,quifurentdespenduz	boeste dudit Ferron , qui furent despenduz
auditlieude..laRochesurYonen	au dit lieu de . . la Roche sur Yon en
despensede	despense de
bouche.Etoumoisdejanvieroudit	bouche . Et ou mois de janvier oudit
anmiliiiic..	an mil iiiic . .
xliiii,nostreaméetfealchevalieretchambellan,	xliiii , nostre amé et feal chevalier et chambellan ,
Guyd’Ossigny,	Guy d ’ Ossigny ,
acompaignédecinquante	acompaigné de cinquante
cinquantehommesdeguerreou	cinquante hommes de guerre ou
environ,arriva..	environ , arriva . .
.devantladicteplacedelaRochesurYon,	. devant la dicte place de la Roche sur Yon ,
,pourillecprendreleditsuppliantet	, pour illec prendre le dit suppliant et
sesserviteurs.Auquelicellui	ses serviteurs . Auquel icellui
suppliantdemandas’ilavoitmandementdenous	suppliant demanda s ’ il avoit mandement de nous
nousdecefaire,offrantencecasluiobeir	nous de ce faire , offrant en ce cas lui obeir
..Aquoynostre	. . A quoy nostre
ditchambellanlui	dit chambellan lui
respondiquenon	respondi que non
,maiscomme	, mais comme
lieutenantde	lieutenant de
nousilavoitpuissance	nous il avoit puissance
.Etpource..	. Et pour ce . .
.que.surcestermes,leditsuppliant	. que . sur ces termes , le dit suppliant
nevoulufaireobeissanceà	ne voulu faire obeissance à
nostreditchambellan	nostre dit chambellan
,icelluinostre	, icellui nostre
nostrechambellans’efforçadeprendreladicte	nostre chambellan s ’ efforça de prendre la dicte
place...Et	place . . . Et
cevoyantleditsuppliant,doubtantla	ce voyant le dit suppliant , doubtant la
lafureurdenostreditchevalier,	la fureur de nostre dit chevalier ,
s.’iladvenoit	s . ’ il advenoit
queladicteplacefust	que la dicte place fust
fustprinse,dist	fust prinse , dist
distàsesgensquechascunsedeffendist,mesmement	dist à ses gens que chascun se deffendist , mesmement
quenostreditchevalierne.faisoitpointapparoir	que nostre dit chevalier ne . faisoit point apparoir
apparoirdeladictecommissionoumandementdenous	apparoir de la dicte commission ou mandement de nous
pource..faire	pour ce . . faire
.Etlorsicelluisuppliant	. Et lors icellui suppliant
,acompaignédetreizeouquatorzehommes,sailly	, acompaigné de treize ou quatorze hommes , sailly
saillydehorsladicteplace,eten	sailly dehors la dicte place , et en
combatantl’undesesdictesgenstiraung.	combatant l ’ un de ses dictes gens tira ung .
trait,de	trait , de
quoyilfrappaungdesgensdenostreditchevalier	quoy il frappa ung des gens de nostre dit chevalier
quienmourut.Etcefait,sedeparty	qui en mourut . Et ce fait , se departy
nostreditchevalieretchambellanet	nostre dit chevalier et chambellan et
sesdictesgens..Pouroccasion	ses dictes gens . . Pour occasion
desquelzcas,ledit	desquelz cas , le dit
suppliant..doubte	suppliant . . doubte
queparrigueurdejusticeil	que par rigueur de justice il
neluiconviengnemiserablementfiner.	ne lui conviengne miserablement finer .
.sesjours,	. ses jours ,
,senostregraceetmisericordenelui	, se nostre grace et misericorde ne lui
sontsurceimparties	sont sur ce imparties
,sicomme	, si comme
commeildit,requeranthumblement	comme il dit , requerant humblement
que,attenduqueen..toussesautres	que , attendu que en . . tous ses autres
autresfaiz,il	autres faiz , il
aestétousjours	a esté tousjours
tousjours..debonnevie	tousjours . . de bonne vie
,renomméeet	, renommée et
honnesteconversacion,sansoncquesmaisavoiresté	honneste conversacion , sans oncques mais avoir esté
actaintouconvaincud’aucunvillain	actaint ou convaincu d ’ aucun villain
cas,blasmeoureprouche,nousluivueillons	cas , blasme ou reprouche , nous lui vueillons
vueillonssubvenirdenostre	vueillons subvenir de nostre
dictegrace.Pourquoynous,ceschoses	dicte grace . Pour quoy nous , ces choses
chosesconsiderées,	choses considerées ,
voulansgraceetmisericordeprefereràrigueur	voulans grace et misericorde preferer à rigueur
dejustice,audit	de justice , au dit
suppliantavonsquicté,remis	suppliant avons quicté , remis
remisetpardonné,etc.,satisfaction	remis et pardonné , etc ., satisfaction
toutesvoyesfaicteàpartiecivilement	toutesvoyes faicte à partie civilement
tantseulement,sefaicten’est	tant seulement , se faicte n ’ est
,etmesmementfaicteà	, et mesmement faicte à
GeuffroyLeFerrondessusnommé.Sidonnons	Geuffroy Le Ferron dessus nommé . Si donnons
enmandement,parcespresentes,	en mandement , par ces presentes ,
ànozamez..	à noz amez . .
.etfeaulxconseillersles	. et feaulx conseillers les
genstenansnostrepresentParlementà	gens tenans nostre present Parlement à
Paris,.aux	Paris , . aux
auxseneschalde	aux seneschal de
Poictou,baillideTouraineetàtous.	Poictou , bailli de Touraine et à tous .
.nozautresjusticiers,etc.DonnéàChinon	. noz autres justiciers , etc . Donné à Chinon
Chinon..,oumoysdefevrierl’	Chinon . . , ou moys de fevrier l ’
andegracemilcccc	an de grace mil cccc
.xlv,etdenostreregnelexxiiiie	. xlv , et de nostre regne le xxiiiie
xxiiiie.Ainsisigné:Parleroy,lescontes	xxiiiie . Ainsi signé : Par le roy , les contes
deFoixetdeTancarville,lessiresde	de Foix et de Tancarville , les sires de
delaVarenne,deBlanville,dePressigny	de la Varenne , de Blanville , de Pressigny
,deMaupasetautres.presens	, de Maupas et autres . presens
.G.Herbert.—Visa.	. G . Herbert .— Visa .
Contentor.E.Duban.	Contentor . E . Duban .
