Loys,parlagracedeDieu	Loys , par la grace de Dieu
DieuroydeFrance.Savoirfaisons	Dieu roy de France . Savoir faisons
faisonsàtous,presensetavenir	faisons à tous , presens et avenir
avenir,nousavoirreceuel’umblesupplicacionde	avenir , nous avoir receue l ’ umble supplicacion de
JehanRobert,lejeune,chargédefemmeet	Jehan Robert , le jeune , chargé de femme et
d’..enfans,demourant	d ’ . . enfans , demourant
auGuédeVeluire,contenantque	au Gué de Veluire , contenant que
quejàpieça.ilfutconjointparmariageavec	que jà pieça . il fut conjoint par mariage avec
sadictefemme,durantlequel	sa dicte femme , durant lequel
lequel,de	lequel , de
luietd’icellesafemmesont	lui et d ’ icelle sa femme sont
yssus,nezetprocréezcertainsenfans	yssus , nez et procréez certains enfans
,dontlesaucunssontencoresenvie;lequel	, dont les aucuns sont encores en vie ; lequel
,durantleditmariage,s’	, durant ledit mariage , s ’
estavecsa	est avec sa
dictefemmeetensonmesnagebienethonnestement	dicte femme et en son mesnage bien et honnestement
gouvernéjusquesàpuislafeste	gouverné jusques à puis la feste
sainctMichielderrenièrepasséeque	sainct Michiel derrenière passée que
il,tempté	il , tempté
del’ennemi	de l ’ ennemi
etgardantlesvachesoulestouchant.ès	et gardant les vaches ou les touchant . ès
marezdelaRonde,ilseprint	marez de la Ronde , il se print
printàunevache,la	print à une vache , la
congneutcharnellementeteustsacompaignie	congneut charnellement et eust sa compaignie
charnelleunefoizseulement.Etaprèsce,	charnelle une foiz seulement . Et après ce ,
congnoissantavoirmesprisenversDieu,nostrecreateur,	congnoissant avoir mespris envers Dieu , nostre createur ,
etjustice,s’estabsenté,sans	et justice , s ’ est absenté , sans
sanscontraintede	sans contrainte de
justice,..dupaysetn’	justice , . . du pays et n ’
yoseroitjamaiz	y oseroit jamaiz
retourner,	retourner ,
,conversernerepairer,doubtantrigueurdejustice,se	, converser ne repairer , doubtant rigueur de justice , se
nozgraceet	noz grace et
etmisericordeneluiestoientsurceimparties,si.	et misericorde ne lui estoient sur ce imparties , si .
commeil.	comme il .
dit,ennous	dit , en nous
humblementrequerantque,.attendu	humblement requerant que , . attendu
cequedessusest	ce que dessus est
dit,qu’	dit , qu ’
il.s’est	il . s ’ est
tousjoursbien	tousjours bien
ethonnestementgouvernéjusquesàpuisla	et honnestement gouverné jusques à puis la
festesaintMichielque,	feste saint Michiel que ,
partemptaciondel’	par temptacion de l ’
’ennemi,ilafait	’ ennemi , il a fait
et..commisledit	et . . commis ledit
cas,qu’	cas , qu ’
iln’enaesté	il n ’ en a esté
estéencoresprinsneaprehendéparjusticeetquede	esté encores prins ne aprehendé par justice et que de
deluimesmes.,	de lui mesmes . ,
sanscontrainte,ilnous.arequis	sans contrainte , il nous . a requis
requisdeceavoirgraceet	requis de ce avoir grace et
etmisericorde,	et misericorde ,
ilnousplaise,	il nous plaise ,
,en..faveurdesesdizfemmeetenfans	, en . . faveur de ses diz femme et enfans
,icellesleurimpartir.Pource	, icelles leur impartir . Pour ce
ceestil,etc.Sidonnonsenmandement	ce est il , etc . Si donnons en mandement
mandement,parcesmesmespresentes,auseneschalde	mandement , par ces mesmes presentes , au seneschal de
dePoictououàson	de Poictou ou à son
lieutenantetàtous	lieutenant et à tous
,etc.DonnéàTours..,	, etc . Donné à Tours . . ,
oumoysdenovembre	ou moys de novembre
l’andegracemil	l ’ an de grace mil
cccc.soixante-neuf,	cccc . soixante - neuf ,
etdenostre	et de nostre
nostrerègneleneufiesme.Ainsisigné:Parle	nostre règne le neufiesme . Ainsi signé : Par le
roy,monsieurlemarquisduPontetautrespresens	roy , monsieur le marquis du Pont et autres presens
.—Visa.Contentor.Duban.	.— Visa . Contentor . Duban .
