Loys,parlagracedeDieuroyde	Loys , par la grace de Dieu roy de
deFrance.Savoirfaisonsà.tous,presens	de France . Savoir faisons à . tous , presens
etavenir,nousavoirreceuel	et avenir , nous avoir receue l
'umblesupplicaciondenostrecheretbien	' umble supplicacion de nostre cher et bien
améJacquesRatault,escuier,seigneurdeCurray(	amé Jacques Ratault , escuier , seigneur de Curray (
sic),contenantqueilaplusieursbelles	sic ), contenant que il a plusieurs belles
terreset.seigneuriessituéesetassisesen	terres et . seigneuries situées et assises en
ennostreseneschaucéedePoictou,etentreles	en nostre seneschaucée de Poictou , et entre les
autresilestseigneurde	autres il est seigneur de
ladicteterreetseigneuriedeCurrayetàcause	ladicte terre et seigneurie de Curray et à cause
d'icelleaplusieurs	d ' icelle a plusieurs
hommesetsubgectz,rentesetrevenues,enlaquelle	hommes et subgectz , rentes et revenues , en laquelle
seigneuriede..Currayleditsuppliantaunemotebelleet	seigneurie de . . Curray ledit suppliant a une mote belle et
aventageuse,sielleestoitfortiffiée,distantdenostre	aventageuse , si elle estoit fortiffiée , distant de nostre
chasteldeLezignendedeuxlieuesouenviron,	chastel de Lezignen de deux lieues ou environ ,
etde..nostre	et de . . nostre
nostreville..dePoictiersdecinqlieuesou	nostre ville . . de Poictiers de cinq lieues ou
ou..environ;laquelleplace	ou . . environ ; laquelle place
,oùilaentencionuserpartiedesesjours	, où il a entencion user partie de ses jours
,pourobvieraux	, pour obvier aux
roberiesquiluipourroientestre	roberies qui lui pourroient estre
faictes,quantilyresideroit,	faictes , quant il y resideroit ,
etpourla..seurté	et pour la . . seurté
despersonnes..de	des personnes . . de
lui,safemmeetmesnaigeetdesesdiz	lui , sa femme et mesnaige et de ses diz
hommesetsubgectz,	hommes et subgectz ,
lesquelzentempsdeguerreethostillitezn'	lesquelz en temps de guerre et hostillitez n '
ontlieuoùilzsepuissent	ont lieu où ilz se puissent
retraire,aiséneplusprouffitable	retraire , aisé ne plus prouffitable
prouffitablepoureulxqueladictemothe	prouffitable pour eulx que ladicte mothe
deCurray,feroitvoulentiers	de Curray , feroit voulentiers
clorreetfortifier,maiz	clorre et fortifier , maiz
maizilnel'	maiz il ne l '
oseroitfairesansnozcongiéet	oseroit faire sans noz congié et
licence,	licence ,
sicommeildit,humblementrequerantnostreprovision	si comme il dit , humblement requerant nostre provision
provision.Pourceestilquenous	provision . Pour ce est il que nous
,ceschoses	, ces choses
considerées,àicelluisuppliant,	considerées , à icellui suppliant ,
enfaveuretconsideraciondesbonsetagreables	en faveur et consideracion des bons et agreables
agreablesservices,parluietlessiens..faiz	agreables services , par lui et les siens . . faiz
,èstempspassez,àfeunostretrès	, ès temps passez , à feu nostre très
chierseigneuretpère,queDieuabsoille,et	chier seigneur et père , que Dieu absoille , et
etànous,	et à nous ,
pourcescauseset..enconsideraciondes[	pour ces causes et . . en consideracion des [
diz.]bonsetagreablesservices,	diz . ] bons et agreables services ,
avonsdonnéetoctroyé,.donnons	avons donné et octroyé , . donnons
donnonsetoctroyons,degraceespecial,plaine..	donnons et octroyons , de grace especial , plaine . .
puissanceetauctoritéroyal,par	puissance et auctorité royal , par
cespresentes	ces presentes
,congiéetlicencedefermer,clorreet	, congié et licence de fermer , clorre et
fortiffierladictemotheetplace	fortiffier ladicte mothe et place
deCurrayde	de Curray de
foussez,paliz,murailles,tours,tournelles	foussez , paliz , murailles , tours , tournelles
tournelles,portail	tournelles , portail
,garites,	, garites ,
barbacannes,	barbacannes ,
ponsleveis,eschiffez..etautresfortifficacionsà	pons leveis , eschiffez . . et autres fortifficacions à
ceneccessaireset..convenables	ce neccessaires et . . convenables
,ettellesetainsiquebonluisemblera.	, et telles et ainsi que bon lui semblera .
Sidonnonsenmandement,parcesdictes.presentes	Si donnons en mandement , par ces dictes . presentes
,à..nozamezetfeaulx	, à . . noz amez et feaulx
gensdenozcomptesettresoriers	gens de noz comptes et tresoriers
àParis,auseneschaldePoictouet	à Paris , au seneschal de Poictou et
àtousnozautres..justiciersetofficiers,ouà	à tous noz autres . . justiciers et officiers , ou à
leurslieuxtenans,presensetavenir,et.	leurs lieuxtenans , presens et avenir , et .
.àchascund'	. à chascun d '
eulx,sicommeàlui	eulx , si comme à lui
luiappartiendra,quede	lui appartiendra , que de
nozpresensgrace.,congiéetlicenceilz	noz presens grace . , congié et licence ilz
ilzfacent,seuffrentetlaissentleditsuppliant,ses	ilz facent , seuffrent et laissent ledit suppliant , ses
seshoirsetsuccesseurs,joir	ses hoirs et successeurs , joir
etuserplainement	et user plainement
plainementet.paisiblement,sans	plainement et . paisiblement , sans
pourcelemolesteroutravailler,oresne	pour ce le molester ou travailler , ores ne
pourletempsavenir	pour le temps avenir
avenir,enaucunemanièreaucontraire;mais	avenir , en aucune manière au contraire ; mais
s'aucunempeschementleuravoitestéou	s ' aucun empeschement leur avoit esté ou
estoitmis	estoit mis
,sil'ostentetmettent,oufacent	, si l ' ostent et mettent , ou facent
reppareretmettresansdelayaupremierestatetdeu	repparer et mettre sans delay au premier estat et deu
deu.Etaffinquece	deu . Et affin que ce
soitchoseferme	soit chose ferme
etestableà	et estable à
tousjours,..	tousjours , . .
nousavonsfaitmettrenostre	nous avons fait mettre nostre
nostreseelàcesdictespresentes.Saufenautres	nostre seel à ces dictes presentes . Sauf en autres
chosesnostredroitet	choses nostre droit et
etl'autruyentoutes.DonnéàLezignen,	et l ' autruy en toutes . Donné à Lezignen ,
oumoysdemayl'ande	ou moys de may l ' an de
gracemilcccc.soixanteetdeux,et	grace mil cccc . soixante et deux , et
denostrerègnelepremier.Ainsisigné:Par	de nostre règne le premier . Ainsi signé : Par
leroy,le	le roy , le
sireduLaupresent.Le	sire du Lau present . Le
Prevost.—Visa.	Prevost .— Visa .
Contentor...J.	Contentor . . . J .
