Philippes,etc.Savoirfaisonsàtouz	Philippes , etc . Savoir faisons à touz
touz,etc.,quecommeGuyondevelort..,	touz , etc ., que comme Guyon de velort . . ,
,nostreaméescuier,entende	, nostre amé escuier , entende
àfonderunechappelerieenl'onneurdeDieu	à fonder une chappelerie en l ' onneur de Dieu
etdetouzsainzpourleremede	et de touz sainz pour le remede
desameetdesamesdesespredecesseurs,nous	de same et des ames de ses predecesseurs , nous
,consideranzlabonnedevocion,laquellenousaprovons	, consideranz la bonne devocion , la quelle nous aprovons
etloons,degraceespecialoctroionsau..	et loons , de grace especial octroions au . .
ditGuyonqueladitechappelerie	dit Guyon que la dite chappelerie
ilpuissedonneretfonderde	il puisse donner et fonder de
dizlivrestornois	diz livres tornois
d'annuelrenteet.lesassoiretassignersus	d ' annuel rente et . les assoir et assigner sus
sus..saterre,sanzfiezet	sus . . sa terre , sanz fiez et
etsanzhautejustice,pourlevivre	et sanz haute justice , pour le vivre
etlasustentacionduchappellain	et la sustentacion du chappellain
,quiseraestabliz	, qui sera establiz
pourladeservir,.	pour la deservir , .
lesquelesdizlivresderentenousvoulonset	les queles diz livres de rente nous voulons et
etoctroionsde	et octroions de
degracespécialque..,puisqueellesserontassises	de grace spécial que . . , puis que elles seront assises
etassignées,lechappellainquiseraestabliz	et assignées , le chappellain qui sera establiz
pourletemps.	pour le temps .
àladitechappellerie	à la dite chappellerie
deservirait,tiengneetperçoive	deservir ait , tiengne et perçoive
perpetuelmentàtouzjourz,sanzestrecontraint	perpetuelment à touz jourz , sanz estre contraint
delesvendreetmetrehorsdesa	de les vendre et metre hors de sa
main,et	main , et
sanzenpaierpouricellesaucunesfinances	sanz en paier pour icelles aucunes finances
ànousneànozsuccesseurs...	à nous ne à noz successeurs . . .
.Etpourcequecesoitfermechose,	. Et pour ce que ce soit ferme chose ,
etc.DonnéàVicennes,l'an	etc . Donné à Vicennes , l ' an
milccc.xxviii.,aumoaysdedecembre.	mil ccc . xxviii ., au moays de decembre .
.Parleroy.Ja...	. Par le roy . Ja . . .
deVert[illy].	de Vert [ illy ].
