Loys,parlagracede	Loys , par la grace de
Dieuroyde	Dieu roy de
France.Savoirfaisons,etc	France . Savoir faisons , etc
.,nous..avoirreceul’umblesupplicacion	., nous . . avoir receu l ’ umble supplicacion
deMathurinAudebaut,jeune	de Mathurin Audebaut , jeune
escuier,aagédexxvi.ans	escuier , aagé de xxvi . ans
ouenviron,contenantquepuisxv	ou environ , contenant que puis xv
xv.moysença,feuGuiart	xv . moys ença , feu Guiart
Audebaut,sonpère,ensonvivant	Audebaut , son père , en son vivant
seigneurdelaPerronnière,	seigneur de la Perronnière ,
estalédevieàtrespas,	est alé de vie à trespas ,
délaissezentreautressesenfans,..René	délaissez entre autres ses enfans , . . René
Audebault,sonfilzaisné,etleditsuppliant,	Audebault , son filz aisné , et ledit suppliant ,
,etparledit	, et par ledit
trespasaledit	trespas a ledit
René,comme	René , comme
filzaisné	filz aisné
aisné,recuillytoutelasuccessionduditGuyartAudebaut,leur	aisné , recuilly toute la succession dudit Guyart Audebaut , leur
leurpère,surlaquelle,selonlacoustumedupaïs	leur père , sur laquelle , selon la coustume du païs
de.Poictou	de . Poictou
Poictou,ilest	Poictou , il est
esttenufaireetbaillerauditsuppliantprovisionenattendant	est tenu faire et bailler audit suppliant provision en attendant
leretourdeladicte..	le retour de ladicte . .
succession;surlaquelleprovisionil	succession ; sur laquelle provision il
illuyabaillécertainshéritaigesestansen	il luy a baillé certains héritaiges estans en
laparroisse	la parroisse
deAubiers,etpourson	de Aubiers , et pour son
loigizluyadonnéunemaisonetjardin	loigiz luy a donné une maison et jardin
assiseauvillaigedelaGalière.Etpour	assise au villaige de la Galière . Et pour
cequeladictemaison.	ce que ladicte maison .
estoitfortruyneuse,icelluy	estoit fort ruyneuse , icelluy
icelluysuppliantanaguières..	icelluy suppliant a naguières . .
entreprinsdefairedémolirladictemaison	entreprins de faire démolir ladicte maison
,pouricellereedifieretl’eslargirsurune	, pour icelle reedifier et l ’ eslargir sur une
saillieestantcontreladictemaison.Et..le	saillie estant contre ladicte maison . Et . . le
lelendemain[	le lendemain [
delafeste]SaintJehan-Baptistederrenièrementpassée	de la feste ] Saint Jehan - Baptiste derrenièrement passée
passée..,setransportaleditsuppliant	passée . . , se transporta ledit suppliant
auditlieude	audit lieu de
laGalièreetyfistalerquatre	la Galière et y fist aler quatre
oucinqhommes,laboureursdebras,lesquelz	ou cinq hommes , laboureurs de bras , lesquelz
abatirentladictemaison,.et	abatirent ladicte maison , . et
et[a]la	et [ a ] la
relevéeduditjour,ainsi	relevée dudit jour , ainsi
quelesdizhommesprenoientleurrepas,separtit	que lesdiz hommes prenoient leur repas , se partit
d’..aveceulx	d ’ . . avec eulx
eulxleditsuppliantetalaregarderlamanière	eulx ledit suppliant et ala regarder la manière
defairesonditédiffice..Et	de faire sondit édiffice . . Et
luyestantillec,survintungnomméJehanPayneau	luy estant illec , survint ung nommé Jehan Payneau
l’aisné,laboureur,demourant	l ’ aisné , laboureur , demourant
auditlieudelaGalière;lequels	audit lieu de la Galière ; lequel s
s’arrestaillecet	s ’ arresta illec et
distauditsuppliant	dist audit suppliant
qu’ilne	qu ’ il ne
souffriroitpointàicelluy..	souffriroit point à icelluy . .
.suppliantqu’ilédifiast	. suppliant qu ’ il édifiast
ouaccreustsonditédificeenmanièrequelechemin	ou accreust sondit édifice en manière que le chemin
cheminquiestoit..illec	chemin qui estoit . . illec
prèsfustempesché.Dontleditsuppliant	près fust empesché . Dont ledit suppliant
,quiest	, qui est
estnoblehomme,voyant	est noble homme , voyant
l’entreprinseouempeschementqueleditPeyneausevantoit	l ’ entreprinse ou empeschement que ledit Peyneau se vantoit
luyfaire,futdesplaisant,	luy faire , fut desplaisant ,
,etàcestecausese	, et à ceste cause se
meurentparollesentre.eulx	meurent parolles entre . eulx
,tellementqueledit	, tellement que ledit
supplianttirasadagueetduplatd	suppliant tira sa dague et du plat d
’icellefrapasurlesespaulesduditPeyneauquatre	’ icelle frapa sur les espaules dudit Peyneau quatre
quatreousixcopssans	quatre ou six cops sans
leblecieroumutiler;etaprèsremisticelluysuppliant	le blecier ou mutiler ; et après remist icelluy suppliant
sadictedagueen	sadicte dague en
sonfourreau,considerantqu’il	son fourreau , considerant qu ’ il
iln’auroit	il n ’ auroit
pointdehonneuràlebatre,	point de honneur à le batre ,
,pourcequ’	, pour ce qu ’
ilestoit	il estoit
vieletancien,etatantsedepartytd’	viel et ancien , et atant se departyt d ’
illecleditPeyneau	illec ledit Peyneau
.Maisincontinentaccourutàsonsecoursungnommé	. Mais incontinent accourut à son secours ung nommé
ThenotPeyneau,sonfrère,et	Thenot Peyneau , son frère , et
etd’.ungrant	et d ’ . un grant
aguillonfortetpoisant.dontiltouchoit	aguillon fort et poisant . dont il touchoit
ses.beufz,frapaungcopoudeuxicelluy	ses . beufz , frapa ung cop ou deux icelluy
icelluy.suppliantsurlateste,	icelluy . suppliant sur la teste ,
parquoyleditsuppliant..soyvoyantainsibatu	par quoy ledit suppliant . . soy voyant ainsi batu
etoultraigé,dobtantquelesdizJehanetThenot..	et oultraigé , dobtant que lesdiz Jehan et Thenot . .
Peyneaulxlevoulsissentencoresplusbatre,tira	Peyneaulx le voulsissent encores plus batre , tira
derechiefsadictedague,ettrouvamoyendeosterledit	derechief sadicte dague , et trouva moyen de oster ledit
aguillonauditJehan..Peyneau,lequel	aguillon audit Jehan . . Peyneau , lequel
lequelencefaisantseprint	lequel en ce faisant se print
àladictedagueetsebleçaungpeuen	à ladicte dague et se bleça ung peu en
deuxdesdoizdesamain	deux des doiz de sa main
,etenla	, et en la
retirantleditsupplianten	retirant ledit suppliant en
enfrapatroysouquatrecops	en frapa troys ou quatre cops
duplaticelluyJehanPayneauparlatesteet	du plat icelluy Jehan Payneau par la teste et
parl’eschine	par l ’ eschine
,tellementqueladictedagueluy	, tellement que ladicte dague luy
saillyhorslamainetcheutàterre.Et	sailly hors la main et cheut à terre . Et
ainsiqueleditsuppliantamassoità	ainsi que ledit suppliant amassoit à
terresadictedague,leditJehanPayneauquiavoit	terre sadicte dague , ledit Jehan Payneau qui avoit
avoitprinsunegrossepierreensonpoing	avoit prins une grosse pierre en son poing
poing,luydonnadeladictepierreungcop	poing , luy donna de ladicte pierre ung cop
parlateste	par la teste
tellementqu’il	tellement qu ’ il
luyabatitsonchapeauetson	luy abatit son chapeau et son
sonbonnet,etnoncontentde	son bonnet , et non content de
celeprintauxcheveuxàdeuxmains..et	ce le print aux cheveux à deux mains . . et
luibaillalajambepourlecuiderabatre	lui bailla la jambe pour le cuider abatre
abatre,tellementqueicelluysuppliant	abatre , tellement que icelluy suppliant
,sentent	, sentent
lemalque	le mal que
luyfaisoitleditPayneau,frapa	luy faisoit ledit Payneau , frapa
icelluyPayneau..dutaillant	icelluy Payneau . . du taillant
de.ladictedagueparl’eschineetluy	de . ladicte dague par l ’ eschine et luy
couppasonvestementsansautrementle..blecier;maisdelà	couppa son vestement sans autrement le . . blecier ; mais delà
leditsuppliantrecouvraetfrapaungautre	ledit suppliant recouvra et frapa ung autre
copdesadictedagueau	cop de sadicte dague au
droitdujarret	droit du jarret
jarreticelluyJehanPayneau	jarret icelluy Jehan Payneau
,tellementqu’ilen	, tellement qu ’ il en
issistsang.Etcefaits’en	issist sang . Et ce fait s ’ en
alaleditPayneauen	ala ledit Payneau en
samaison,oùlelendemain	sa maison , où le lendemain
lendemainensuivant,parfaultedegouvernementouautrement,	lendemain ensuivant , par faulte de gouvernement ou autrement ,
ilaladevieà	il ala de vie à
trespas.Al’occasion	trespas . A l ’ occasion
occasionduquelcas	occasion duquel cas
cas.leditsuppliants’estabsenté	cas . ledit suppliant s ’ est absenté
absenté,etc.,requerant,etc	absenté , etc ., requerant , etc
.Pourquoy..,etc.,àicelluy	. Pourquoy . . , etc ., à icelluy
suppliantavons..quicté,etc.Si	suppliant avons . . quicté , etc . Si
donnonsenmandementauseneschalduPoictou,	donnons en mandement au seneschal du Poictou ,
etc.DonnéàParis	etc . Donné à Paris
,oumoys	, ou moys
dejuillet,l	de juillet , l
’andegracemilcccc.soixante	’ an de grace mil cccc . soixante
soixantedixseptet	soixante dix sept et
denostrerègnele	de nostre règne le
xvime.Ainsi	xvime . Ainsi
Ainsisigné:ParleConseil.De	Ainsi signé : Par le Conseil . De
Villechartre.—Visa.Contentor.	Villechartre .— Visa . Contentor .
.Picart.	. Picart .
