Charles,etc.Savoirfaisons	Charles , etc . Savoir faisons
àtouz,.presens	à touz , . presens
etavenir,	et avenir ,
,ànousavoirestéhumblementexposédelapartie	, à nous avoir esté humblement exposé de la partie
deJehanCholet	de Jehan Cholet
,povrelaboureur	, povre laboureur
,chargiédefemmeetd	, chargié de femme et d
’unpetitenfant,dela	’ un petit enfant , de la
parroissed’Azayen	parroisse d ’ Azay en
lachastelleniedeSaintMaixent..enPoitou,comme	la chastellenie de Saint Maixent . . en Poitou , comme
anetdemia	an et demi a
ouenviron.,	ou environ . ,
pour.cequeunappelléTurpelinqui	pour . ce que un appellé Turpelin qui
quiestoithommedetrèsmauvaiserenommée	qui estoit homme de très mauvaise renommée
,c’estassavoirpillart	, c ’ est assavoir pillart
,larron,robeur,	, larron , robeur ,
,..rompeurdehuys,	, . . rompeur de huys ,
,efforceurdefemmes,alant	, efforceur de femmes , alant
denuitetdejourpourgreveret	de nuit et de jour pour grever et
etendommagierautrui,estoitetconversoitsurle	et endommagier autrui , estoit et conversoit sur le
ditpays,enla	dit pays , en la
dicteparroissed	dicte parroisse d
’Azayetenpluseurs	’ Azay et en pluseurs
autreslieuxdeenviron	autres lieux de environ
,enusantdesmauvaistiezdessusdictes,JehanLevrier	, en usant des mauvaistiez dessus dictes , Jehan Levrier
,JehanJoulinetpluseursautres,en.la	, Jehan Joulin et pluseurs autres , en . la
compaigniedesquelzledit	compaignie desquelz le dit
ditexposantestoit,sefussentassemblezetdefaitfussent	dit exposant estoit , se fussent assemblez et de fait fussent
,sanslicenceetauctoritédejustice,	, sans licence et auctorité de justice ,
alezpar	alez par
nuitenunvillage	nuit en un village
ouhamel..	ou hamel . .
appelléLaignes,prèsdudit	appellé Laignes , près du dit
lieudeSaintMaixent,là	lieu de Saint Maixent , là
làoùilzavoientoydire	là où ilz avoient oy dire
direqueleditmalfaiteurestoit,lequelilztrouverent	dire que le dit malfaiteur estoit , lequel ilz trouverent
,leprindrentaucuns..	, le prindrent aucuns . .
.d’iceulxetbatirent,dontmorts’	. d ’ iceulx et batirent , dont mort s ’
’ensuyenlapersonned’icelluiTurpelin,	’ ensuy en la personne d ’ icellui Turpelin ,
àlaquellepriseetbateureleditexposantne	à la quelle prise et bateure le dit exposant ne
touchaenaucunemaniere.Pour	toucha en aucune maniere . Pour
occasiondu	occasion du
duquelfaitle	du quel fait le
ditexposant.,doubtantrigueur	dit exposant . , doubtant rigueur
dejustice,s’est	de justice , s ’ est
estabsenté,dupaysetn..’	est absenté , du pays et n . . ’
’yoseroit	’ y oseroit
retourner,se	retourner , se
nostregracenelui	nostre grace ne lui
luiestoitsurcefaite,ennoushumblement	lui estoit sur ce faite , en nous humblement
suppliantque,attenducequedit-	suppliant que , attendu ce que dit -
est,etquele	est , et que le
leditexposant.atoutletemps	le dit exposant . a tout le temps
desavieestéhommede	de sa vie esté homme de
debonnevie,renomméeethonnesteconversacion.,sanz	de bonne vie , renommée et honneste conversacion . , sanz
cequ’ilfustoncquesreprisd	ce qu ’ il fust oncques repris d
’aucunvillainblasme,	’ aucun villain blasme ,
fors..ducas	fors . . du cas
casdessusdit,oùilnetouchaaucunement,	cas dessus dit , où il ne toucha aucunement ,
commeditest,etlamauvaisevieetrenommée	comme dit est , et la mauvaise vie et renommée
duditTurpelin,..quiparpluseursfoiz	du dit Turpelin , . . qui par pluseurs foiz
foizavoitestédenuit.etdejour	foiz avoit esté de nuit . et de jour
jourenl	jour en l
l’ostelduditexposant,luiavoitrompul	l ’ ostel du dit exposant , lui avoit rompu l
’uisdesonhosteletvoluefforcersafemme	’ uis de son hostel et volu efforcer sa femme
,sicomme	, si comme
commeildit,nous	comme il dit , nous
nousluivueillonssurceextendrenostredicte	nous lui vueillons sur ce extendre nostre dicte
grace.Pourquoynous,considerées.	grace . Pour quoy nous , considerées .
.leschosesdessusdictes,voulansencestepartiemisericorde	. les choses dessus dictes , voulans en ceste partie misericorde
prefereràrigueurdejustice,au	preferer à rigueur de justice , au
ditexposant,oucasdessusdit	dit exposant , ou cas dessus dit
,avonsquicté,remisetpardonné,	, avons quicté , remis et pardonné ,
,etparcespresentes,denostre	, et par ces presentes , de nostre
graceespecialetauctoritéroyal,quictons,remettonset	grace especial et auctorité royal , quictons , remettons et
etpardonnonsleditfait,avectoutepaine	et pardonnons le dit fait , avec toute paine
paine,amendeetoffensecorporelle	paine , amende et offense corporelle
corporelle,criminelleetcivilequ	corporelle , criminelle et civile qu
qu’ilpuetpource	qu ’ il puet pour ce
estreencourusenversnous,etlerestituonsàsa	estre encourus envers nous , et le restituons à sa
bonnefameet	bonne fame et
renommée,aupays	renommée , au pays
etàsesbiens	et à ses biens
nonconfisquez,satisfaction	non confisquez , satisfaction
faicteàpartiecivilementtant	faicte à partie civilement tant
seulement,premierementetavanttouteeuvre	seulement , premierement et avant toute euvre
,enimposantsurcesilence..perpetuel	, en imposant sur ce silence . . perpetuel
ànostreprocureur.Sidonnonsenmandement	à nostre procureur . Si donnons en mandement
mandement,parlateneurde	mandement , par la teneur de
decespresentes,auseneschaldeXantongeetàtouz	de ces presentes , au seneschal de Xantonge et à touz
nozautresjusticiersetofficiers,àleurslieuxtenans	noz autres justiciers et officiers , à leurs lieuxtenans
lieuxtenans,presenset	lieuxtenans , presens et
avenir,etàchascund’eulx	avenir , et à chascun d ’ eulx
eulx,sicommeàluiappartendra	eulx , si comme à lui appartendra
appartendra,quede..nostrepresentegraceet	appartendra , que de . . nostre presente grace et
etremissionilz..facent,seuffrentetlaissentledessus	et remission ilz . . facent , seuffrent et laissent le dessus
ditJehanCholetjoiretuserpaisiblement.	dit Jehan Cholet joir et user paisiblement .
..,sanzle	. . , sanz le
molester,traveillierouempeschier	molester , traveillier ou empeschier
,ou..lesouffrirestremolesté,traveillié	, ou . . le souffrir estre molesté , traveillié
ouempeschiéores	ou empeschié ores
nyoutemps	ny ou temps
tempsavenir,enaucunemaniere;maizse	temps avenir , en aucune maniere ; maiz se
aucunsdeses	aucuns de ses
sesbiensnonconfisquezpourcesontsaisizouarrestez,	ses biens non confisquez pour ce sont saisiz ou arrestez ,
luimettentoufacentmettreàplainedelivrance	lui mettent ou facent mettre à plaine delivrance
.Etpourcequecesoitferme	. Et pour ce que ce soit ferme
choseet	chose et
estableàtouzjours,	estable à touzjours ,
,nousavonsfaitmettre	, nous avons fait mettre
nostreseelàcespresentes.Saufenautreschoses	nostre seel à ces presentes . Sauf en autres choses
nostredroit	nostre droit
etl’autrui	et l ’ autrui
entoutes.Donné	en toutes . Donné
àParis,leixe.jourd’aoust	à Paris , le ixe . jour d ’ aoust
l’andegracemilccc.iiiixx	l ’ an de grace mil ccc . iiiixx
etix,et	et ix , et
etdenostreregnele	et de nostre regne le
leixe.Parleroy	le ixe . Par le roy
,presensmonseigneurleducde	, presens monseigneur le duc de
deTouraineetle	de Touraine et le
BesguedeVillaines.K.deTemplo	Besgue de Villaines . K . de Templo
