Charles,etc.Savoirfaisons	Charles , etc . Savoir faisons
faisonsàtous,presensetavenir,delapartie	faisons à tous , presens et avenir , de la partie
deChariotdeSaintGelais,escuier,	de Chariot de Saint Gelais , escuier ,
nousavoirhumblement	nous avoir humblement
estéexposé..que	esté exposé . . que
que,commelelundiavantPasquesfleuriesderrenierementpasséesot	que , comme le lundi avant Pasques fleuries derrenierement passées ot
unan,leditexposantfeustou	un an , le dit exposant feust ou
villagedeSaintGelaisprès	village de Saint Gelais près
deSaintMaixent,oupaysdePoitou.,	de Saint Maixent , ou pays de Poitou . ,
ouquellieuileustoye	ou quel lieu il eust oye
lamesse,etaprès	la messe , et après
cesefeustdepartidel'eglisepouraler	ce se feust departi de l ' eglise pour aler
àunechappelledeNostreDameestant	à une chappelle de Nostre Dame estant
estantouditvillage,etenalantle	estant ou dit village , et en alant le
droitcheminàladicte	droit chemin à la dicte
dictechapelle,eustpassépardevant	dicte chapelle , eust passé par devant
devantl'osteld'unmareschalassizen	devant l ' ostel d ' un mareschal assiz en
ycelluivillage,ou..quellieu	ycellui village , ou . . quel lieu
ileustrencontréd'aventureunappellé	il eust rencontré d ' aventure un appellé
appelléLoysHervé,ditFoubert,duvillage	appellé Loys Hervé , dit Foubert , du village
villagede..Chaurray,lequelavoitdonnémenacesau	village de . . Chaurray , lequel avoit donné menaces au
au..munierduditsuppliantdele	au . . munier dudit suppliant de le
lefaireadjourner,	le faire adjourner ,
sicommeon	si comme on
onavoitrapportéàycelluiexposant	on avoit rapporté à ycellui exposant
.Etpourcele	. Et pour ce le
leditexposantdistauditLoysqu.'	le dit exposant dist audit Loys qu . '
ilavoitmeneaciédefaire..adjournersondit	il avoit meneacié de faire . . adjourner son dit
munier,sanzcauseraisonnable,etlui	munier , sanz cause raisonnable , et lui
requistqu'ils'..envoulsist	requist qu ' il s ' . . en voulsist
voulsistdeporter,etleditLoys	voulsist deporter , et le dit Loys
respondiquepointne.s'endeporteroit	respondi que point ne . s ' en deporteroit
deporteroitpourleditexposant.Surquoysemeurentparoles	deporteroit pour le dit exposant . Sur quoy se meurent paroles
contencieusesentreicelluiexposant,d'unepart	contencieuses entre icellui exposant , d ' une part
,etledit.	, et le dit .
Loys,d'autre,ettantqueicellui	Loys , d ' autre , et tant que icellui
Loysledesmenti	Loys le desmenti
,dontle	, dont le
leditexposantquiest..nobleshomsetde	le dit exposant qui est . . nobles homs et de
grantetde	grant et de
debonnelignéeetancienne	de bonne lignée et ancienne
,soysentant..injuriéetcommeesmeuetcouroucié	, soy sentant . . injurié et comme esmeu et couroucié
decequele	de ce que le
leditLoysl'avoitdesmenti,tira	le dit Loys l ' avoit desmenti , tira
uncoustel..qu!	un coustel . . qu !
!il..avoitàsasainture,de	! il . . avoit à sa sainture , de
dedeux..piezde	de deux . . piez de
longouenviron	long ou environ
environentoutes	environ en toutes
choses,et	choses , et
etparchaude.coleferydu	et par chaude . cole fery du
tranchantdudit	tranchant du dit
costeluncop	costel un cop
surlatesteduditLoys,tantqu	sur la teste du dit Loys , tant qu
qu'illuifist	qu ' il lui fist
uneplaie;etatantsedepartiledit	une plaie ; et atant se departi le dit
ditexposant..Etle	dit exposant . . Et le
ditLoysenfutmené	dit Loys en fut mené
etluifutsadicteplaieappareilliée	et lui fut sa dicte plaie appareilliée
,etlejour	, et le jour
jourdesgransPasques	jour des grans Pasques
prouchainsaprèsensuivans,alaàsoneglise..parrochialet	prouchains après ensuivans , ala à son eglise . . parrochial et
etchantaau	et chanta au
lettrinenladicteeglise,en	lettrin en la dicte eglise , en
aidantàdireillec	aidant à dire illec
illeclagrant	illec la grant
messe.Etle	messe . Et le
mercrediprouchainensuivant,ala	mercredi prouchain ensuivant , ala
encertainlieuassezprèsdesonhostel	en certain lieu assez près de son hostel
,oùilavoitlaboureurs	, où il avoit laboureurs
quiluiaidoientàfaireduchanvre,etse	qui lui aidoient à faire du chanvre , et se
endormiou	endormi ou
ditlieu,sanzestreautrementcouvertquedece	dit lieu , sanz estre autrement couvert que de ce
qu'ilavoitvestu	qu ' il avoit vestu
;etquantilfutresveillié,sesentimalade	; et quant il fut resveillié , se senti malade
malade,telementqu'il	malade , telement qu ' il
nesepot	ne se pot
soustenir,etconvintqu	soustenir , et convint qu
'ilfeustlevéetmenéenson	' il feust levé et mené en son
sonhostel,où	son hostel , où
oùildemouramalade	où il demoura malade
aulitparl'espacededouze.jours	au lit par l ' espace de douze . jours
joursouenviron	jours ou environ
;àlafinduquel	; à la fin du quel
queltemps,	quel temps ,
ilaladevieàtrespassement,	il ala de vie à trespassement ,
pourcausede.laplaieetbleceureà	pour cause de . la plaie et bleceure à
luifaicte..parledit	lui faicte . . par le dit
ditexposant.Pourlaquellechosele	dit exposant . Pour laquelle chose le
ditexposant,doubtantrigueurdejustice,s'	dit exposant , doubtant rigueur de justice , s '
estabsentédupayset	est absenté du pays et
n'yoseretourner	n ' y ose retourner
,ainçoisseroit..en	, ainçois seroit . . en
adventured	adventure d
d'enestreexilliéà.touzjours,se	d ' en estre exillié à . touzjours , se
parnousneluiestoit	par nous ne lui estoit
surceimpartienostre	sur ce impartie nostre
grace,sicommeildit,ennoushumblement	grace , si comme il dit , en nous humblement
suppliantque,commeycellui	suppliant que , comme ycellui
ycelluiexposantsoitchargiédefemmeetdepluseurs	ycellui exposant soit chargié de femme et de pluseurs
enffans,etaitsatisfaitàpartie	enffans , et ait satisfait à partie
partie,etqueentousautres	partie , et que en tous autres
casilsoitde	cas il soit de
bonnefameet	bonne fame et
renommée,noussurceluivueillonspourveoir	renommée , nous sur ce lui vueillons pourveoir
denostre..dicte	de nostre . . dicte
dictegrace.Pourquoynous,	dicte grace . Pour quoy nous ,
ces.chosesconsiderées,voulansmisericorde	ces . choses considerées , voulans misericorde
misericordeestrepreferéeàrigueurde	misericorde estre preferée à rigueur de
dejustice,àycelluisuppliantavonsouditcas	de justice , à ycellui suppliant avons ou dit cas
remis,quictiéetpardonné,etc	remis , quictié et pardonné , etc
.Sidonnons	. Si donnons
donnonsenmandementpar.cespresentesaubailli	donnons en mandement par . ces presentes au bailli
baillideTouraineetdesressorsetExempcionsd'Anjou	bailli de Touraine et des ressors et Exempcions d ' Anjou
Anjou,dePoictouetduMaine,et	Anjou , de Poictou et du Maine , et
àtousnozautresjusticiers,.	à tous noz autres justiciers , .
etc.DonnéàParis,oumois	etc . Donné à Paris , ou mois
demayl'	de may l '
andegracemil	an de grace mil
milquatrecens	mil quatre cens
etun,etde	et un , et de
denostreregneleXXie.Parleroy,	de nostre regne le XXie . Par le roy ,
,monseigneurlecontedeNevers,messireRegnautd'	, monseigneur le conte de Nevers , messire Regnaut d '
Angennes,etpluseursautrespresens.	Angennes , et pluseurs autres presens .
Gauchier.	Gauchier .
